_W________
W_________
W_________
W_.W_P____
__PW_B_P_B
...W_B_W_W
WWWWWWWWWW
