W_________
W_________
W______W__
W__._.__W_
W_______WW
W___P___DW
WWWWWWWWWW
