W _ _ _ _ _ _ _ _ _
W _ P _ _ _ _ _ _ _
_ _ _ _ _ _ _ _ _ _
_ _ B _ _ _ _ B _ _
W _ P B B B B P _ _
W _ W B W P W _ W P
W W W W W W W W W W