W _ _ _ _ _ _ _ _ _
W _ _ _ _ _ _ _ _ _
_ _ _ _ _ _ _ _ _ _
_ _ _ P _ _ _ _ _ _
W _ _ B _ B B B _ B
W _ W B W P W P W P
W W W W W W W W W W