D W B W _ _ _ _ _ _
W W W _ _ _ _ _ P _
W _ _ _ _ _ _ _ _ _
_ _ _ _ _ _ _ _ _ _
_ _ B B _ _ B _ _ B
W B W P W _ W _ P W
W W W W W W W W W W