(7, 10, 10)
__________
__________
__________
____P_D___
__________
__________
____PD____
__________
__________
__________

***

__________
__________
__________
_____PD___
__________
__________
____PD____
__________
__________
__________

***

__________
__________
__________
_____PD___
__________
__________
____PD____
__________
__________
__________

***

__________
__________
__________
_____PD___
__________
__________
____PD____
__________
__________
__________

***

__________
__________
__________
_____PD___
__________
__________
____PD____
__________
__________
__________

***

__________
__________
__________
_____PD___
__________
__________
____PD____
__________
__________
__________

***

TTTTTTTTTT
TTTTTTTTTT
TTTTTTTTTT
TTTTTTTTTT
TTTTTTTTTT
TTTTTTTTTT
TTTTTTTTTT
TTTTTTTTTT
TTTTTTTTTT
TTTTTTTTTT

***

