_W_______W
_W_______W
_W_______W
_W_______W
WW___W___W
WDP__WB__W
WWWWWWWWWW
