....WWWW__
....______
....__DW__
...WWWWW__
..________
..________
WWWWWWWWWW