._........
..........
.WWWWWW...
._........
..........
..........
WWWWWWWWWW