_________________
_________________
_________________
_________________
________W__W_____
_______BW_BW__PO_
_WWWWWWWWWWWWWWW_
WWWWWWWWWWWWWWWWW