_________________
_________________
_________________
_________________
________W__W_____
_______BW_BW___G_
_WWWWWWWWWWWWWWW_
WWWWWWWWWWWWWWWWW