_ _ _ _ _ _ _ _ _ _
_ _ _ _ _ _ _ _ _ _
_ _ _ _ _ _ _ _ _ _
_ B _ _ _ _ _ _ _ _
_ P _ B _ _ _ _ _ B
_ B W P W P _ P B B
W W W W W W W W W W