__________
__________
__________
_B________
_P_B_____B
_BWPWP_PBB
WWWWWWWWWW