_ _ _ _ _ _ P _ _ _
_ _ _ _ _ _ _ _ _ _
_ _ _ _ _ _ _ _ _ _
_ _ _ _ _ _ _ _ _ _
B P _ B _ _ _ _ _ _
_ B W P W _ P _ B B
W W W W W W W W W W