__________
__WWWW____
_____DP__W
__________
_WW_______
WD________
WWWWWWWWWW