_ W W W W W _ _ _ _
_ _ _ _ _ _ W _ _ _
_ _ _ _ _ W W W _ _
_ _ _ _ _ W _ _ _ _
_ _ P _ _ _ _ _ _ _
W _ W W _ _ _ _ _ _
W W W W W W W W W W