_ W W W W W _ _ _ _
_ _ _ _ _ _ W _ _ P
_ _ _ _ _ W W W _ _
_ _ _ _ _ W _ _ _ _
_ _ _ _ _ _ _ _ _ _
W B W W _ _ _ _ _ _
W W W W W W W W W W