..........
..........
..........
..........
__........
W_........
WWWWWWWWWW