_ _ _ _ _ W B W W B
_ _ _ _ _ W B W _ W
_ _ _ _ _ _ W _ _ _
_ _ _ B _ _ _ _ _ _
P _ B P _ B _ B P B
B _ B B _ _ B B B W
W W W W W W W W W W