_ _ _ P _ W B W W B
_ _ _ _ _ W B W _ W
_ _ _ _ _ _ W _ _ _
_ _ _ _ B _ _ _ B _
_ _ B _ P _ _ B P _
B P B B _ B _ B B W
W W W W W W W W W W