. . . . . . . . . .
. . . . . . _ W . .
. . . . . . D . . .
. . . . . . . . . W
. . . _ W W W W W W
X X X X X X X X X X
W W W W W W W W W W