. . . . . . _ . . .
. . . . . . D . . .
. . . . . . W W . .
. . . . . . . _ . _
W . W . . . W . . .
W _ W W . W D W . W
W W W W W W W W W W