. . . . . . _ . . .
. . . . . . D . . .
. . . . . . W W . .
. . . . . W W _ _ _
W . W . . . W . _ _
W . W W . W D W . W
W W W W W W W W W W