WWWWWWWWW
W_______W
W_______W
W_______W
W__P___DW
W_______W
W_______W
W_______W
WWWWWWWWW