WWWWWWWWW
W_______W
W_______W
W_______W
W___P__DW
W_______W
W_______W
W_______W
WWWWWWWWW