.____.....
.____.....
..._______
________W_
________W_
_________W
WWWWWWWWWW