..........
..........
..........
...._.....
.WW_______
W_W_W_____
WWWWWWWWWW