_ _ _ _ _ _ _ _ _ _ _ _ _ _ _ _ _ _ _ _ _ _
_ _ _ _ _ _ _ _ _ _ _ _ _ _ _ _ _ _ _ _ _ _
_ _ _ _ _ _ _ _ _ _ _ _ _ _ _ _ _ _ _ _ _ _
_ _ _ _ B B B _ _ _ _ _ _ _ _ _ _ _ _ _ _ _
_ _ _ _ V W B _ _ _ _ _ _ _ _ _ _ _ _ _ _ _
_ _ B B V W B _ _ _ B B B _ _ B B B _ _ _ _
_ _ V B B W B _ _ _ B W V _ _ V W H _ _ _ _
_ B B B V W B B B B B W V B B V W _ _ _ O _
_ W W W W W W W W W W W W W W W W W W W W _
W W W W W W W W W W W W W W W W W W W W W W