W _ _ . . . . _ _ W
W _ _ _ _ _ _ _ _ W
W _ _ _ _ _ _ _ _ W
W _ _ _ _ _ _ _ _ W
W _ _ _ _ _ _ _ _ W
W _ _ _ P B _ _ D W
W W W W W W W W W W