W______W_W
W___W_W__W
W____W___W
W_____W__W
W____W___W
W____W___W
WWWWWWWWWW