W_____WWW_
W________W
W________W
W________W
W________W
W_____P_DW
WWWWWWWWWW
