W__....__W
W________W
W________W
W________W
W___B____W
W___P____W
WWWWWWWWWW