____BWWW_P
B___W____B
W________B
_________W
_________W
_P_____BBW
WWWWWWWWWW