B___BWWW_P
B___W____B
W_______BB
__B______W
B___B___PW
P___P___BW
WWWWWWWWWW