_ _ _ _ B W W W _ _
B _ _ _ W _ _ _ _ B
W _ _ _ _ _ _ _ _ B
_ _ _ _ _ _ _ _ B W
B _ B _ _ _ B _ P W
_ _ P _ P _ P _ B W
W W W W W W W W W W