_WW_____W_
W________W
W________W
W________W
W________W
W____P__DW
WWWWWWWWWW