_ W W _ _ _ _ _ W _
W _ _ _ _ _ _ _ _ W
W _ _ _ _ _ _ _ _ W
W _ _ _ _ _ _ _ _ W
W _ _ _ _ _ _ _ _ W
W _ _ _ _ _ P _ D W
W W W W W W W W W W