..........
..........
.D._......
....__W___
______W___
______W___
WWWWWWWWWW