__.._.....
________BW
____.._BBW
..__BB_WW.
_WWWWWWW._
W_______W_
W_______W_
W_______WW
W___P___DW
WWWWWWWWWW