__.._.....
________..
______...W
____BB.W..
_WWWWWWW._
W_______W_
W_______W_
W_______WW
W____P__DW
WWWWWWWWWW