. . . . . .
. . . . . P
. . . . . .
. . . . . .
. . . . . .
. D . . . .