__________
___BP_____
___WW___B_
_P____B_B_
_B_BW_P_W_
BP_PW_BBW_
WWWWWWWWWW