__W_______
_W________
W_________
W__WP_____
W_________
W___P___DW
WWWWWWWWWW
