__________
__________
___W______
BH_W__W__O
WWWWWWWWWW