__________
__________
__HW______
BBVW__W__O
WWWWWWWWWW