__________
__BBB_____
__VWB_____
BBVWH_W__O
WWWWWWWWWW