__________
__BBBH____
__VWBV____
BBVWBVW__O
WWWWWWWWWW