_ _ _ _ _ _ _ _ _ _
_ _ B B B _ _ _ _ _
_ _ V W B H _ _ _ _
B B V W B V W _ _ O
W W W W W W W W W W