_ _ _ _ _ _ _ _ _ _
_ _ B B H _ _ _ _ _
_ _ V W _ _ _ _ _ _
B B V W _ _ W _ _ O
W W W W W W W W W W