(7, 8, 8)
________
________
________
________
__D_____
_____P__
________
________

***

________
________
________
________
__D__P__
________
________
________

***

________
________
________
________
__D_P___
________
________
________

***

________
________
________
________
__DP____
________
________
________

***

________
________
________
________
__DP____
________
________
________

***

________
________
________
________
__DP____
________
________
________

***

TTTTTTTT
TTTTTTTT
TTTTTTTT
TTTTTTTT
TTTTTTTT
TTTTTTTT
TTTTTTTT
TTTTTTTT

***

