_W_____W__
_WBB__W_W_
_WWWWW__W_
W_______W_
W_______WW
W___P___DW
WWWWWWWWWW
