(11, 8, 8)
________
_D__D___
_P______
________
____P___
_P______
_D______
________

***

________
_D__D___
_P______
________
________
_P__P___
_D______
________

***

________
_D__D___
_P______
________
________
_P___P__
_D______
________

***

________
_D__D___
_P______
________
________
_P____P_
_D______
________

***

________
_D__D___
_P______
________
______P_
_P______
_D______
________

***

________
_D__D___
_P______
________
_____P__
_P______
_D______
________

***

________
_D__D___
_P______
________
_____P__
_P______
_D______
________

***

________
_D__D___
_P______
_____P__
________
_P______
_D______
________

***

________
_D__D___
_P___P__
________
________
_P______
_D______
________

***

________
_D__DP__
_P______
________
________
_P______
_D______
________

***

TTTTTTTT
TTTTTTTT
TTTTTTTT
TTTTTTTT
TTTTTTTT
TTTTTTTT
TTTTTTTT
TTTTTTTT

***

