...____...
...____...
...WWWW...
...____...
........__
........__
WWWWWWWWWW