_WWWW_____
W_________
W_________
W_________
W_________
WD_____P_W
WWWWWWWWWW
