. . . . . . . . . .
. . . . . . . . . .
. . . _ D . . . . .
. . . . W . . . . .
. . . . . . . . . .
_ W W _ W . . . W _
W W W W W W W W W W