_ _ W _ _ _ _ _ _ _
_ _ W _ _ _ _ _ _ _
_ _ _ _ _ _ _ _ _ _
W _ _ _ _ _ _ _ _ _
W _ _ _ _ _ _ _ _ _
W B _ _ _ _ W D W _
W W W W W W W W W W