_ _ P _ _ _ _ _ _ _
_ _ _ _ _ _ _ _ _ B
_ _ _ _ _ _ _ _ _ P
_ _ _ _ _ _ _ _ _ B
_ _ _ _ B _ _ B _ B
D _ _ _ P B P B _ B
W W W W W W W W W W