_ _ P _ _ _ _ _ _ _
_ _ _ _ B _ _ _ _ _
_ _ _ _ _ _ B _ _ _
_ _ _ _ _ _ _ _ _ B
_ _ _ _ _ _ _ _ B B
D _ P _ _ _ P _ P B
W W W W W W W W W W