B _ _ W W
P _ _ _ _
B _ _ _ P
P B B B B
W W W W W