________
_D___D__
________
________
__P_____
________
______P_
________

***

________
_D___D__
________
________
__P_____
______P_
________
________

***

________
_D___D__
________
________
__P___P_
________
________
________

***

________
_D___D__
________
__P_____
_____P__
________
________
________

***

________
_D___D__
__P_____
________
________
_____P__
________
________

***

________
_D___D__
_P______
________
________
____P___
________
________

***

________
_D___D__
_P______
________
____P___
________
________
________

***

________
_D___D__
_P______
____P___
________
________
________
________

***

________
_D___D__
_P__P___
________
________
________
________
________

***

________
_D__PD__
_P______
________
________
________
________
________

***

TTTTTTTT
TTTTTTTT
TTTTTTTT
TTTTTTTT
TTTTTTTT
TTTTTTTT
TTTTTTTT
TTTTTTTT

***

