..........
.....__...
.....___..
....._____
__________
W_________
WWWWWWWWWW