(7, 6, 6)
WWWWWW
W_P_WW
WDW_WW
WWW_WW
W___WW
WWWWWW

***

WWWWWW
WP__WW
WDW_WW
WWW_WW
W___WW
WWWWWW

***

WWWWWW
WP__WW
WDW_WW
WWW_WW
W___WW
WWWWWW

***

WWWWWW
WP__WW
WDW_WW
WWW_WW
W___WW
WWWWWW

***

WWWWWW
WP__WW
WDW_WW
WWW_WW
W___WW
WWWWWW

***

WWWWWW
WP__WW
WDW_WW
WWW_WW
W___WW
WWWWWW

***

TTTTTT
TTTTTT
TTTTTT
TTTTTT
TTTTTT
TTTTTT

***

