_ _ _ _ _ _ _ W W W
_ _ _ _ _ _ _ _ _ _
_ _ _ B _ _ _ _ _ _
_ _ _ P _ _ _ B _ _
_ _ _ B _ _ _ P _ _
_ _ _ B W _ W B W _
W W W W W W W W W W