_ B _ _ _ W W _ _ _
_ _ _ _ _ _ _ _ _ _
_ P B _ _ _ _ _ _ _
_ _ B B P _ _ _ _ _
_ _ W W _ B _ _ B _
_ _ D W W W W B B _
W W W W W W W W W W