_ _ _ _ _ W W _ _ _
_ B _ _ _ _ _ _ _ _
_ _ B _ _ _ _ _ _ P
_ P B B B _ _ _ _ _
_ _ W W P _ _ _ B _
_ P D W W W W B B _
W W W W W W W W W W