_ _ _ _ _ _ _ _ _ _
_ _ W _ _ _ _ _ _ _
_ W _ _ _ _ _ _ _ _
W _ _ _ _ _ _ _ _ _
W _ _ _ _ _ _ _ _ _
W _ _ P _ _ _ _ D W
W W W W W W W W W W