........__
......____
........__
_W________
W_________
W________W
WWWWWWWWWW