. . . . . . . . . . _ _ _ W _ . . . . .
. . . . . . . . . . _ _ D W _ _ . . . .
. . P . . . . . . . W W W W _ _ _ _ _ _
. . . . . . . . . . _ _ _ _ _ _ _ _ _ _
. . . . . . . . . . . . _ _ _ _ _ B _ W
. . . . . . . . . . . . . . P . _ . B W
W W W W W W W W W W W W W W W W W W W W