__P____B_B
_______WWW
____B__W__
____P____B
__B__B_B_P
B_B__B_PB_
WWWWWWWWWW