W P _ _ W _ _ _ _ _
W W W W _ W _ _ _ _
_ _ _ _ _ W B _ _ _
_ _ _ _ _ W B _ _ _
_ B _ _ _ W B B _ _
_ P B _ B W B B B P
W W W W W W W W W W