_ W D W W _ _ _ W _
_ _ _ _ _ _ _ _ _ _
_ _ _ _ _ _ _ _ _ _
_ W B B B W W _ _ _
W D W B W W W W W W
_ _ _ _ _ _ _ _ _ _
W W W W W W W W W W