_ _ _ _ _ _ _ _ _ _
_ _ _ _ _ _ _ _ _ _
_ _ _ _ _ _ _ _ _ _
_ _ _ _ _ _ . . . .
_ _ _ _ _ . . . . .
_ _ _ _ W . . . . .
_ _ _ . . . . . . .