_ W W _ _
_ _ _ _ _
P _ B _ _
B _ P _ W
W W W W W