__________
__________
__________
__________
_________.
.......P..
WWWWWWWWWW