D W _ _ _ _ W _ _ _
W W _ _ _ _ W _ _ _
_ _ _ _ _ _ _ _ _ _
_ _ _ _ _ _ _ _ _ _
_ _ _ B P _ P _ B B
P B B B W _ B _ B _
W W W W W W W W W W