D W _ _ _ _ W _ _ _
W W _ _ _ _ W _ _ _
_ _ _ _ _ _ _ _ _ _
_ _ _ _ B _ _ B _ _
_ _ P B P _ _ _ B B
_ B B B W _ B P B _
W W W W W W W W W W