B_B_P_P_B_
_______B__
P__P___B_B
____BB_B_P
B___B__P__
__B_P__W_B
WWWWWWWWWW