_ _ _ _ P _ _ _ _ _
_ _ _ _ _ _ _ B _ _
_ _ _ _ _ B _ B _ _
_ _ _ _ B _ _ B _ _
_ _ B _ B _ _ P _ _
_ _ _ _ P _ B W _ _
W W W W W W W W W W