_ _ _ _ _ W W _ _ _
_ _ _ _ W W W W _ W
W W W W W W _ _ _ _
_ W W _ _ B B W P W
_ _ _ _ _ _ _ W W W
_ _ _ _ _ _ W W W _
W W W W W W W W W W