(11, 8, 8)
________
________
________
___P____
______D_
________
________
________

***

________
________
________
__P_____
______D_
________
________
________

***

________
________
________
________
__P___D_
________
________
________

***

________
________
________
________
______D_
__P_____
________
________

***

________
________
________
________
______D_
___P____
________
________

***

________
________
________
________
___P__D_
________
________
________

***

________
________
________
________
____P_D_
________
________
________

***

________
________
________
________
_____PD_
________
________
________

***

________
________
________
________
_____PD_
________
________
________

***

________
________
________
________
_____PD_
________
________
________

***

TTTTTTTT
TTTTTTTT
TTTTTTTT
TTTTTTTT
TTTTTTTT
TTTTTTTT
TTTTTTTT
TTTTTTTT

***

