..........
..........
..........
._________
__________
W________W
WWWWWWWWWW