B _ _ _ _
P _ _ _ B
_ _ _ _ _
D _ P B _
W W W W W