W________W
W________W
W________W
W____.___W
W____W___W
W____WB__W
WWWWWWWWWW
