B _ _ _ _ _ _ _ W W
_ _ B _ _ _ _ _ _ _
_ _ P _ _ _ P _ _ _
_ _ W B _ _ B B _ _
P _ W B _ _ B _ _ B
B _ W B _ B W B _ P
W W W W W W W W W W