P _ _ _ _ W _ W B P
_ _ _ _ W _ _ _ W W
_ _ B _ W _ _ _ _ _
B _ P _ _ _ _ _ _ _
P B B _ _ B _ _ _ _
_ W B B B _ _ B B W
W W W W W W W W W W