_ _ P _ _ W _ W B _
P _ _ _ W _ _ _ W W
_ _ B _ W _ _ _ _ _
B _ P _ _ _ _ _ _ B
_ B B _ _ _ _ _ _ P
P W B _ B B _ _ B W
W W W W W W W W W W