__B_______
_WW___P___
__________
__B_B_____
__BBP_P___
_PBBW_D_BP
WWWWWWWWWW