_ B P _ _ _ _ _ _ _
_ W W _ _ _ _ _ _ _
_ _ _ _ P _ _ _ _ _
_ _ _ _ _ _ P _ _ _
_ B B _ _ _ _ _ _ B
_ _ B B W _ D _ _ P
W W W W W W W W W W