_ _ P _ P _ B _ B _
_ W W _ _ _ _ _ _ _
_ _ _ _ P _ B _ _ _
_ _ _ _ _ _ P _ _ _
_ _ B _ _ _ _ _ B _
_ B B _ W _ D _ P _
W W W W W W W W W W