__WWWWWWW_
__W______W
_W_______W
W________W
WB_______W
WBB__WP__W
WWWWWWWWWW