_P_WBW_W__
____WW____
_B_____P_B
_W________
BWB_B_____
WWW_P___WP
WWWWWWWWWW