___W_____.
____WWWWW_
______WW__
WP____D___
WWWWWWW___
_______W_W
WWWWWWWWWW
