W____W....
W____W___W
W____WWWWW
W_________
W________W
W__W__W__W
WWWWWWWWWW