W___......
W___.._._W
W___.WWWWW
W_________
W________W
W__W__W__W
WWWWWWWWWW