_____W____
___WW_____
__________
____PW____
__PDW_____
__________
WWWWWWWWWW