_ _ _ _ _ _ _ _ _ _
_ B _ _ _ _ _ _ _ _
_ B _ _ _ _ _ _ _ _
B B _ _ _ _ _ _ _ B
P B _ _ _ _ _ B _ B
B W B _ _ _ B P B W
W W W W W W W W W W