____P_____
PB______P_
_B________
_BP______P
_B_____B_B
_WBP___P_W
WWWWWWWWWW