P _ _ _ _ _ _ _ _ _
_ B _ _ _ _ _ _ _ _
_ B B _ _ _ _ _ _ _
_ B P _ _ _ _ _ _ _
_ B _ _ _ _ _ _ _ B
_ W B _ _ _ B P _ W
W W W W W W W W W W