(11, 12, 12)
____________
____________
____________
____________
________P___
___D_P______
____________
________D___
___PD_______
____________
____________
____________

***

____________
____________
____________
________P___
____________
___DP_______
____________
________D___
___PD_______
____________
____________
____________

***

____________
____________
____________
____________
________P___
___DP_______
____________
________D___
___PD_______
____________
____________
____________

***

____________
____________
____________
________P___
____________
___DP_______
____________
________D___
___PD_______
____________
____________
____________

***

____________
____________
____________
_______P____
____________
___DP_______
____________
________D___
___PD_______
____________
____________
____________

***

____________
____________
____________
________P___
____________
___DP_______
____________
________D___
___PD_______
____________
____________
____________

***

____________
____________
____________
____________
________P___
___DP_______
____________
________D___
___PD_______
____________
____________
____________

***

____________
____________
____________
____________
____________
___DP___P___
____________
________D___
___PD_______
____________
____________
____________

***

____________
____________
____________
____________
____________
___DP_______
________P___
________D___
___PD_______
____________
____________
____________

***

____________
____________
____________
____________
____________
___DP_______
________P___
________D___
___PD_______
____________
____________
____________

***

TTTTTTTTTTTT
TTTTTTTTTTTT
TTTTTTTTTTTT
TTTTTTTTTTTT
TTTTTTTTTTTT
TTTTTTTTTTTT
TTTTTTTTTTTT
TTTTTTTTTTTT
TTTTTTTTTTTT
TTTTTTTTTTTT
TTTTTTTTTTTT
TTTTTTTTTTTT

***

