W___.._W..
W___.__W_W
W___.WWWWW
W_________
W________W
W__W_____W
WWWWWWWWWW