_B________
_W_____B__
W______P__
_______B__
BP____BWW_
PBW_WBPWD_
WWWWWWWWWW