_ _ _ _ _ _ _ _ _ _
_ W _ _ _ _ _ _ _ _
W _ _ _ B _ _ P B _
_ _ B _ _ _ _ B _ _
B _ P _ P _ B W W _
P B W _ W B P W D _
W W W W W W W W W W