___P_____B
B________P
P_________
_________B
_______B_W
__B_DWBP_W
WWWWWWWWWW