__________
__________
__________
__________
__________
.W..W.W.W.
WWWWWWWWWW