_ _ _ _ _ B W W B W
_ _ _ _ _ _ W _ _ _
_ _ _ _ _ _ _ _ _ _
_ _ _ _ _ _ _ _ _ _
_ _ _ _ _ _ _ _ _ W
_ _ _ W W W W W W _
W W W W W W W W W W