__________
__________
___H______
___VW_____
_BBVW_____
_VBBW_____
BBBVW____O
WWWWWWWWWW