_ _ _ _ _ _ _ _ _ _
_ _ _ _ _ _ _ _ _ _
_ _ _ B B B _ _ _ _
_ _ _ V W B _ _ _ _
_ B B V W B _ _ _ _
_ V B B W B _ _ _ _
B B B V W B B H _ O
W W W W W W W W W W