_ _ _ _ _ _ _ _ _ _
_ _ _ _ _ _ _ _ _ _
_ _ _ _ _ _ _ _ _ _
_ _ _ _ W _ _ _ _ _
_ B B H W _ _ _ _ _
_ V B B W _ _ _ _ _
B B B V W _ _ _ _ O
W W W W W W W W W W