..........
..........
......_...
.......___
__________
W___W_____
WWWWWWWWWW