P _ _ _ _ _ _ _ _ _
_ _ _ _ _ _ _ P W _
_ _ B _ _ _ _ _ W _
_ _ P _ _ _ _ _ W _
B _ W _ B _ _ W W _
W _ W B P _ _ W D _
W W W W W W W W W W