.....___W_
..P.____W_
....P__W_W
....WWW__W
...______W
W__.____DW
WWWWWWWWWW