_ W W _ _ _ W W _ W
W _ _ _ _ _ _ W _ W
W _ _ B _ _ _ _ W _
_ _ _ _ _ B _ _ _ _
_ _ _ _ _ _ B B _ _
_ B W _ W P W P B B
W W W W W W W W W W