________
__P_____
_____D__
________
_D______
______P_
________
________

***

________
_P______
_____D__
________
_D______
________
______P_
________

***

________
__P_____
_____D__
________
_D______
________
_____P__
________

***

________
_P______
_____D__
________
_D______
________
____P___
________

***

________
__P_____
_____D__
________
_D______
____P___
________
________

***

________
_P______
_____D__
________
_D______
_____P__
________
________

***

________
__P_____
_____D__
________
_D___P__
________
________
________

***

________
_P______
_____D__
_____P__
_D______
________
________
________

***

________
________
_P___D__
_____P__
_D______
________
________
________

***

________
________
_____D__
_P___P__
_D______
________
________
________

***

TTTTTTTT
TTTTTTTT
TTTTTTTT
TTTTTTTT
TTTTTTTT
TTTTTTTT
TTTTTTTT
TTTTTTTT

***

