W________W
W________W
W________W
W________W
.____W___W
.P___W___W
WWWWWWWWWW