(11, 10, 10)
__________
__________
____D__P__
_______D__
__________
__________
_______P__
__P___D___
__________
__________

***

__________
__________
____D__P__
_______D__
__________
__________
__________
__P___DP__
__________
__________

***

__________
__________
____D__P__
_______D__
__________
__________
__________
___P__DP__
__________
__________

***

__________
__________
____D__P__
_______D__
__________
__________
___P______
______DP__
__________
__________

***

__________
__________
____D__P__
_______D__
__________
___P______
__________
______DP__
__________
__________

***

__________
__________
____D__P__
_______D__
__________
___P______
__________
______DP__
__________
__________

***

__________
__________
____D__P__
_______D__
___P______
__________
__________
______DP__
__________
__________

***

__________
__________
____D__P__
___P___D__
__________
__________
__________
______DP__
__________
__________

***

__________
__________
___PD__P__
_______D__
__________
__________
__________
______DP__
__________
__________

***

__________
__________
___PD__P__
_______D__
__________
__________
__________
______DP__
__________
__________

***

TTTTTTTTTT
TTTTTTTTTT
TTTTTTTTTT
TTTTTTTTTT
TTTTTTTTTT
TTTTTTTTTT
TTTTTTTTTT
TTTTTTTTTT
TTTTTTTTTT
TTTTTTTTTT

***

