_ _ _ _ _ _ _ _ _ _ _ _
_ W W W W W W W W W W _
_ B H _ _ _ _ _ _ _ O _
_ _ _ _ _ _ _ _ _ _ _ _
_ _ _ _ _ _ _ _ _ _ _ _
_ _ _ _ _ _ _ _ _ _ _ _
_ _ _ _ _ _ _ _ _ _ _ _
_ _ _ _ _ _ _ _ _ _ _ _
_ _ _ _ _ _ _ _ _ _ _ _
_ B H _ _ _ _ _ _ _ O _
_ W W W W W W W W W W _
W W W W W W W W W W W W