________
__P__D__
__D_____
______P_
________
________
_D____P_
________

***

________
__P__D__
__D___P_
________
________
________
_D___P__
________

***

________
__P__DP_
__D_____
________
________
________
_D__P___
________

***

________
__P__DP_
__D_____
________
________
________
_D___P__
________

***

________
__P__DP_
__D_____
________
________
_____P__
_D______
________

***

________
__P__DP_
__D_____
________
________
_____P__
_D______
________

***

________
__P__DP_
__D_____
________
________
____P___
_D______
________

***

________
__P__DP_
__D_____
________
________
___P____
_D______
________

***

________
__P__DP_
__D_____
________
________
__P_____
_D______
________

***

________
__P__DP_
__D_____
________
________
_P______
_D______
________

***

TTTTTTTT
TTTTTTTT
TTTTTTTT
TTTTTTTT
TTTTTTTT
TTTTTTTT
TTTTTTTT
TTTTTTTT

***

