..________
..__W_____
..________
W______P__
WBP___..__
WBB___WB__
WWWWWWWWWW