______..__
__________
___W______
___WB____.
_WWWWWWWW_
W________W
W________W
W________W
W__W__W__W
WWWWWWWWWW