_ _ _ _ _ _ . . _ _
_ _ _ _ _ _ _ _ _ _
_ _ _ W _ _ _ _ _ _
. _ _ W B _ P B _ _
_ W W W W W W W W _
W _ _ _ _ _ _ _ _ W
W _ _ _ _ _ _ _ _ W
W _ _ _ _ _ _ _ _ W
W _ _ W _ _ W _ _ W
W W W W W W W W W W