W W W W W W W _ _ _
_ _ _ _ _ _ _ _ _ _
W D _ _ P _ W _ _ _
W W W W W W W _ _ _
_ _ _ _ _ _ _ _ _ _
_ _ _ _ _ _ _ _ _ _
W W W W W W W W W W