_ _ _ _ _ W W W W W
_ P W _ _ _ _ _ _ _
_ _ W _ _ _ _ _ _ _
_ _ W _ _ _ _ _ _ _
P _ W _ W _ _ _ _ _
_ B W _ W B P B _ _
W W W W W W W W W W