_ _ _ _ _ W W W W W
_ _ W _ _ _ _ _ _ _
_ P W _ _ _ _ _ _ B
_ _ W _ _ _ _ _ _ P
P _ W _ W P _ _ _ _
_ B W _ W B _ B _ _
W W W W W W W W W W