. _ . _ . _ . _ . .
. _ . _ . _ . _ W W
. _ . _ W _ . _ _ _
W _ . _ _ _ . . . .
_ _ . . . . . . . .
. . . . W . . W . B
W W W W W W W W W W