(7, 8, 8)
________
________
________
________
_____P__
__D_____
________
________

***

________
________
________
________
_____P__
__D_____
________
________

***

________
________
________
________
____P___
__D_____
________
________

***

________
________
________
________
___P____
__D_____
________
________

***

________
________
________
________
________
__DP____
________
________

***

________
________
________
________
________
__DP____
________
________

***

TTTTTTTT
TTTTTTTT
TTTTTTTT
TTTTTTTT
TTTTTTTT
TTTTTTTT
TTTTTTTT
TTTTTTTT

***

