_ _ W W _ _ _ _ _ _
_ _ _ _ _ _ _ W _ _
_ _ _ _ _ _ _ W _ _
B _ _ _ W P _ _ _ _
P _ P B W _ B _ _ _
B B B B W B B _ B W
W W W W W W W W W W