_B_______B
__________
__________
___B___P__
BB___BWB__
WPW_WPWB_B
WWWWWWWWWW