_ _ _ _ _ _ _ _ _ _
_ _ _ _ _ _ _ _ _ _
_ _ _ _ _ _ _ _ _ _
_ B _ _ _ _ _ P _ _
B P _ _ _ B W B _ _
W _ W B W P W B B _
W W W W W W W W W W