..........
..........
..........
....W_____
W...W__.__
W..WWDW.._
WWWWWWWWWW