. . . . . . . . . .
. . . . . . . . . .
. . . . . . . . . .
. . . . W _ _ _ _ _
W . . . W _ _ . _ _
W . . W W D W . . _
W W W W W W W W W W