_W________
_W________
_W________
_W________
W____W____
W___BW_PDW
WWWWWWWWWW
