__WBBW_PDW
__WWWWWWWW
__W_______
__WWWWWWW_
_W______WW
W______PDW
WWWWWWWWWW
