W W . . . . . . . .
_ _ _ . . . . . . .
W D _ . . . . . . .
W W W . . . . . . .
. . . . . . . . . .
. . . _ _ . . . . .
W W W W W W W W W W