____..W___
WWWD..W.__
__WWWWWW__
__________
__________
WW.__.W.__
WWWWWWWWWW