. . . P . .
. . . . . .
. . . . D .
. . . . . .
. . . . . .
. . . . . .