. . . . _ _ . . . _
. . . . _ _ P D W _
. . . . . . . . . .
. . . . . . . . . .
. . . . . . . . . .
. . . . . . . . . W
W W W W W W W W W W