_ _ _ _ _ _ _ _ _ W
_ _ _ _ B _ _ _ _ W
_ _ _ _ B B P _ _ W
_ W W W W W W W W W
W _ _ _ _ _ _ _ _ _
W _ _ . _ _ _ _ D W
W W W W W W W W W W