_________W
____BP___W
____BB___W
_WWWWWWWWW
W_________
W___P___DW
WWWWWWWWWW