_________W
____W____W
____WB___W
_WWWWWWWWW
W_________
W_____P_DW
WWWWWWWWWW