..........
......_...
.......DW_
W__WWWWWW_
WWW______W
__W______W
WWWWWWWWWW