.....WWWW_
....______
....__PDW_
_.WWWWWWW_
__________
W_________
WWWWWWWWWW