__________
__________
__________
__________
_____P____
..........
WWWWWWWWWW