..._WWW_..
..........
..........
....WW....
..........
..........
WWWWWWWWWW