. . . . . . . . . .
. . _ _ . . . . . .
. _ _ P _ D W . . .
. . . . . . . . . .
. . . . . . . . . .
. . . . . . . . . _
W W W W W W W W W W