W W W W W W W W
W P _ _ _ _ _ W
W _ _ _ _ _ _ W
W _ _ _ _ _ _ W
W _ _ _ _ _ _ W
W _ _ _ _ _ _ W
W _ _ _ _ _ D W
W W W W W W W W