WWWWWWWW
W______W
W______W
W______W
WP_____W
W______W
W_____DW
WWWWWWWW