________
_D______
___P__P_
________
________
_D___D__
__P_____
________

***

________
_D______
__P___P_
________
________
_D___D__
_P______
________

***

________
_D______
_P___P__
________
________
_D___D__
_P______
________

***

________
_D______
_P__P___
________
________
_D___D__
_P______
________

***

________
_D______
_P__P___
________
________
_D___D__
_P______
________

***

________
_D______
_P___P__
________
________
_D___D__
_P______
________

***

________
_D______
_P__P___
________
________
_D___D__
_P______
________

***

________
_D______
_P______
____P___
________
_D___D__
_P______
________

***

________
_D______
_P______
________
____P___
_D___D__
_P______
________

***

________
_D______
_P______
________
________
_D__PD__
_P______
________

***

TTTTTTTT
TTTTTTTT
TTTTTTTT
TTTTTTTT
TTTTTTTT
TTTTTTTT
TTTTTTTT
TTTTTTTT

***

