______D_WW
D_P_P_WW__
W_________
__D___B_B_
_BWWW_P_WW
_WWDWBB_DW
WWWWWWWWWW