..____....
..____....
..WWWW....
..____....
..........
..........
WWWWWWWWWW