BW________
____BW____
_______DW_
________BW
W__WBBBWB_
___WWW____
WWWWWWWWWW