WW_____WWB
_W_____WWB
___B_____W
___B______
_B_B__BWP_
_PBWBPBWWB
WWWWWWWWWW