WW_P___WW_
_W_____WWB
___B_____W
___B______
_B_B_B_W_P
_PBWBPBWWB
WWWWWWWWWW