(11, 6, 6)
WWWWWW
WWD__W
WW___W
WW___W
WW_P_W
WWWWWW

***

WWWWWW
WWD__W
WW___W
WW___W
WWP__W
WWWWWW

***

WWWWWW
WWD__W
WW___W
WW___W
WW_P_W
WWWWWW

***

WWWWWW
WWD__W
WW___W
WW___W
WW__PW
WWWWWW

***

WWWWWW
WWD__W
WW___W
WW___W
WW_P_W
WWWWWW

***

WWWWWW
WWD__W
WW___W
WW___W
WWP__W
WWWWWW

***

WWWWWW
WWD__W
WW___W
WW___W
WW_P_W
WWWWWW

***

WWWWWW
WWD__W
WW___W
WW___W
WWP__W
WWWWWW

***

WWWWWW
WWD__W
WW___W
WWP__W
WW___W
WWWWWW

***

WWWWWW
WWD__W
WWP__W
WW___W
WW___W
WWWWWW

***

TTTTTT
TTTTTT
TTTTTT
TTTTTT
TTTTTT
TTTTTT

***

