_______BBB
_BPBPB_WPW
BB_B_B_WWW
WWWWWWWW__
_________B
_BW_BWD__B
WWWWWWWWWW