_ _ _ _ _ _ _ B B B
_ B P B P B _ W P W
B B _ B _ B _ W W W
W W W W W W W W _ _
_ _ _ _ _ _ _ _ _ B
_ B W _ B W D _ _ B
W W W W W W W W W W