_ _ B _ _ _ _ B B B
_ B P B _ B _ W P W
_ B _ B P B B W W W
W W W W W W W W _ _
_ _ _ _ _ _ _ _ _ B
_ B W _ B W D _ P B
W W W W W W W W W W