..........
..._......
....D.....
..WWW.....
.......W..
.......W.W
WWWWWWWWWW