_ _ _ W _ _ _ _ _ P
_ W _ _ _ _ W W _ _
_ W _ _ W W W _ _ _
_ _ _ _ _ _ _ _ W W
P _ _ _ _ _ _ _ W W
_ _ _ _ _ D W _ W W
W W W W W W W W W W