. _ _ W W W . . . .
. _ _ _ _ _ _ . . .
. _ _ W D P _ . . .
. _ _ W W W W . . .
. _ _ _ _ _ _ _ _ _
W B _ _ _ _ _ _ _ _
W W W W W W W W W W