W___..___W
W________W
W________W
W________.
W___P____.
W__...___W
W________W
W___W____W
WD__W___.W
WWWWWWWWWW