W _ _ _ _ _ _ W B W
W _ _ _ B _ W _ W _
W _ _ _ P _ W _ _ _
W _ _ _ _ _ _ _ _ _
W _ B _ B _ _ _ _ _
D _ W _ W P W B B P
W W W W W W W W W W