__W_______
_W________
_W________
W_________
W_________
W__P____DW
WWWWWWWWWW