__W_______
_W________
_W________
W_________
W_________
W___P___DW
WWWWWWWWWW