W _ _ B _ _ _ W _ B
W _ _ P _ _ _ W _ _
_ _ _ _ _ P _ _ _ P
P _ _ B _ _ _ _ _ _
B _ P W _ _ _ _ _ B
W B W W B _ B B _ B
W W W W W W W W W W