. . . . . _ . . . _
. . . . . _ _ D W _
. . . . . . . . . .
. . . . . . . . . .
. . . . . . . . . .
. . . . . . . . . .
W W W W W W W W W W