__W_______
WDW_______
_WW_______
__________
__.B______
.WBBP_BW__
WWWWWWWWWW