________
__P___D_
__D___P_
________
________
_D__PD__
_P______
________

***

________
__P___D_
__D___P_
________
________
_D__PD__
_P______
________

***

________
__P___D_
__D___P_
________
________
_D__PD__
_P______
________

***

________
__P___D_
__D___P_
________
________
_D__PD__
_P______
________

***

________
__P___D_
__D___P_
________
________
_D__PD__
_P______
________

***

________
__P___D_
__D___P_
________
________
_D__PD__
_P______
________

***

________
__P___D_
__D___P_
________
________
_D__PD__
_P______
________

***

________
__P___D_
__D___P_
________
________
_D__PD__
_P______
________

***

________
__P___D_
__D___P_
________
________
_D__PD__
_P______
________

***

________
__P___D_
__D___P_
________
________
_D__PD__
_P______
________

***

TTTTTTTT
TTTTTTTT
TTTTTTTT
TTTTTTTT
TTTTTTTT
TTTTTTTT
TTTTTTTT
TTTTTTTT

***

