. . . . . .
. . . . . .
. . . . . .
. . . D . .
P . . . . .
. . . . . .