W__....__W
W________W
W________W
W________W
._____W__W
._P_B_W__W
WWWWWWWWWW