W__....__W
W________W
W________W
W________W
W__B__W__W
W__P__W__W
WWWWWWWWWW