W _ _ . . . . _ _ W
W _ _ _ _ _ _ _ _ W
W _ _ _ _ _ _ _ _ W
W _ _ _ _ _ _ _ _ W
W _ _ B _ _ W _ _ W
W _ _ P _ _ W _ _ W
W W W W W W W W W W