....__..._
....__PDW_
..........
..........
..........
.........W
WWWWWWWWWW