________WW
____P_____
____W_____
__________
_WWWW___W_
W___WB_W_W
WWWWWWWWWW