_ _ _ _ _ _ _ _ _ _
_ W _ _ _ _ _ _ _ _
_ _ _ _ _ _ _ _ _ _
_ _ _ _ _ _ _ _ _ _
_ _ _ _ _ W _ W _ _
_ _ W P W W _ W _ W
W W W W W W W W W W