_ _ _ _ _ _ _ _ _ _
_ W W W W W W W W _
W _ _ _ _ _ _ _ _ W
W _ _ _ _ _ _ _ _ W
W _ _ _ _ _ _ _ _ W
W _ _ P _ B _ _ D W
W W W W W W W W W W