X X X . X X X X X X
X X X P X X X X X X
X X X X X X X X X X
X X X X X X X X X X
X X X X X X X X X X
X X X X X X X X X X
W W W W W W W W W W