_____B__B_
PB___BP_B_
W__P_W_WWW
__________
_BW____B__
_PWPBP___P
WWWWWWWWWW
