. . . . . . . . _ _
. . . . . . . _ W W
. . . . . . _ _ D W
. . . . . . . . W W
. . . . . _ . . W _
. . . . . . B B W _
W W W W W W W W W W