_________W
_________W
__W______W
_W_______W
W____P___W
W___W____W
WWWWWWWWWW