W_________
W______W__
W_______W_
W_______W_
W_______WW
W____P__DW
WWWWWWWWWW
