__________
__________
____B_B_W_
____W___W_
____W_____
B___WBB_PB
WWWWWWWWWW