(11, 10, 10)
__________
__________
______D___
__P_______
__________
__________
___D______
_______P__
__________
__________

***

__________
__________
______D___
__P_______
__________
__________
___D______
______P___
__________
__________

***

__________
__________
______D___
__P_______
__________
__________
___D______
_______P__
__________
__________

***

__________
__________
__P___D___
__________
__________
__________
___D______
______P___
__________
__________

***

__________
__________
___P__D___
__________
__________
__________
___D__P___
__________
__________
__________

***

__________
__________
______D___
___P______
__________
__________
___D______
______P___
__________
__________

***

__________
__________
______D___
____P_____
__________
__________
___D______
______P___
__________
__________

***

__________
__________
______D___
_____P____
__________
__________
___D______
_____P____
__________
__________

***

__________
__________
_____PD___
__________
__________
__________
___D______
____P_____
__________
__________

***

__________
__________
_____PD___
__________
__________
__________
___DP_____
__________
__________
__________

***

TTTTTTTTTT
TTTTTTTTTT
TTTTTTTTTT
TTTTTTTTTT
TTTTTTTTTT
TTTTTTTTTT
TTTTTTTTTT
TTTTTTTTTT
TTTTTTTTTT
TTTTTTTTTT

***

