W _ _ _ _ D _ W W _
W _ _ B _ W _ _ _ W
_ _ _ _ _ W _ _ _ _
_ _ _ _ _ _ _ B _ _
_ _ B _ _ _ _ P _ P
_ B B P _ _ W B B W
W W W W W W W W W W