______________________
______________________
______________________
_____W__________W_____
____BW__B____W__BW____
___BBW__P___BW__BW__O_
_WWWWWWWWWWWWWWWWWWWW_
WWWWWWWWWWWWWWWWWWWWWW