______________________
______________________
______________________
_____W___________W____
____BW_____B_W__BW____
___BBW_____PBW__BW__O_
_WWWWWWWWWWWWWWWWWWWW_
WWWWWWWWWWWWWWWWWWWWWW