______________________
______________________
______________________
_____W______B____W____
____BW______PW__BW____
___BBW______BW__BW__O_
_WWWWWWWWWWWWWWWWWWWW_
WWWWWWWWWWWWWWWWWWWWWW