_PWB______
WWWW______
_____B____
___P_P____
__WW______
D_______B_
WWWWWWWWWW