_ P W B _ _ _ _ _ _
W W W W _ P _ _ _ _
_ _ _ _ _ _ _ _ _ _
_ _ B P _ _ _ _ B _
_ _ W W _ _ _ _ P _
D _ _ _ _ _ B _ B _
W W W W W W W W W W