_ P W B _ _ _ _ _ _
W W W W _ _ _ _ _ _
_ _ _ _ _ B _ _ _ _
_ _ _ P _ P _ _ _ _
_ _ W W _ _ _ _ _ _
D _ _ _ _ _ _ _ B _
W W W W W W W W W W