(7, 10, 10)
__________
__________
__________
__________
__________
___D______
______P___
__________
__________
__________

***

__________
__________
__________
__________
__________
___D__P___
__________
__________
__________
__________

***

__________
__________
__________
__________
__________
___D_P____
__________
__________
__________
__________

***

__________
__________
__________
__________
__________
___DP_____
__________
__________
__________
__________

***

__________
__________
__________
__________
__________
___DP_____
__________
__________
__________
__________

***

__________
__________
__________
__________
__________
___DP_____
__________
__________
__________
__________

***

TTTTTTTTTT
TTTTTTTTTT
TTTTTTTTTT
TTTTTTTTTT
TTTTTTTTTT
TTTTTTTTTT
TTTTTTTTTT
TTTTTTTTTT
TTTTTTTTTT
TTTTTTTTTT

***

