(11, 8, 8)
________
______P_
____D___
_D______
________
____D___
_P____P_
________

***

________
_____P__
____D___
_D______
________
____D___
_P___P__
________

***

________
____P___
____D___
_D______
________
____D___
_P__P___
________

***

________
____P___
____D___
_D______
________
____D___
_P__P___
________

***

________
____P___
____D___
_D______
________
____D___
_P__P___
________

***

________
____P___
____D___
_D______
________
____D___
_P__P___
________

***

________
____P___
____D___
_D______
________
____D___
_P__P___
________

***

________
____P___
____D___
_D______
________
____D___
_P__P___
________

***

________
____P___
____D___
_D______
________
_P__D___
____P___
________

***

________
____P___
____D___
_D______
_P______
____D___
____P___
________

***

TTTTTTTT
TTTTTTTT
TTTTTTTT
TTTTTTTT
TTTTTTTT
TTTTTTTT
TTTTTTTT
TTTTTTTT

***

