_ _ _ W _ _ B W _ _
_ _ _ W W W _ _ W _
_ W W _ _ _ _ _ _ _
W W D _ P _ _ _ _ _
_ _ _ _ _ _ _ _ _ _
_ _ W W _ W _ _ _ W
W W W W W W W W W W