__________
_W________
_W________
__WWWW____
_W________
_W______BW
WWWWWWWWWW