. . _ _ _ _ . . . .
. . _ _ _ _ . . . .
. . . _ _ _ _ W _ _
W _ _ _ _ _ _ W _ _
W _ _ W _ _ _ W _ _
_ _ _ W _ _ _ W _ _
W W W W W W W W W W