..........
..........
....._._..
....__W___
__._____.W
W..DW._.WW
WWWWWWWWWW