________
__P_____
_____P__
________
____D___
________
_D______
________

***

________
_P______
________
_____P__
____D___
________
_D______
________

***

________
________
_P______
____P___
____D___
________
_D______
________

***

________
________
________
_P__P___
____D___
________
_D______
________

***

________
________
_P______
____P___
____D___
________
_D______
________

***

________
_P______
________
____P___
____D___
________
_D______
________

***

________
________
_P______
____P___
____D___
________
_D______
________

***

________
________
________
_P__P___
____D___
________
_D______
________

***

________
________
________
____P___
_P__D___
________
_D______
________

***

________
________
________
____P___
____D___
_P______
_D______
________

***

TTTTTTTT
TTTTTTTT
TTTTTTTT
TTTTTTTT
TTTTTTTT
TTTTTTTT
TTTTTTTT
TTTTTTTT

***

