__________
__________
W_B_B_____
_WWWW__P__
_W_____B__
DW____BW_B
WWWWWWWWWW