B_P_B_B___
B___P_P___
W_________
_WWWW_____
_W____PBB_
DW_____WPB
WWWWWWWWWW