_ _ W _ _ _ _ _ _ W
_ W _ _ _ _ _ _ _ W
W _ _ _ _ _ _ _ _ W
W _ _ _ _ P _ _ _ W
W _ _ _ W _ _ _ _ W
W _ _ B W _ _ _ _ W
W W W W W W W W W W