.WW.WWWWWW
__________
________PW
_____..WW.
._________
W_______PW
WWWWWWWWWW