.WWWWWWWWW
._________
._PDP____W
.WW.......
__________
W____.___W
WWWWWWWWWW