..........
..........
.......D..
.......W..
..._WWWWW_
W_W_______
WWWWWWWWWW