(11, 8, 8)
WWWWWWWW
WWWWWWWW
WD__PDWW
W_____WW
WP____WW
W___PDWW
WWWWWWWW
WWWWWWWW

***

WWWWWWWW
WWWWWWWW
WD__PDWW
WP____WW
W_____WW
W___PDWW
WWWWWWWW
WWWWWWWW

***

WWWWWWWW
WWWWWWWW
WD__PDWW
WP____WW
W_____WW
W___PDWW
WWWWWWWW
WWWWWWWW

***

WWWWWWWW
WWWWWWWW
WD__PDWW
WP____WW
W_____WW
W___PDWW
WWWWWWWW
WWWWWWWW

***

WWWWWWWW
WWWWWWWW
WD__PDWW
WP____WW
W_____WW
W___PDWW
WWWWWWWW
WWWWWWWW

***

WWWWWWWW
WWWWWWWW
WD__PDWW
WP____WW
W_____WW
W___PDWW
WWWWWWWW
WWWWWWWW

***

WWWWWWWW
WWWWWWWW
WD__PDWW
WP____WW
W_____WW
W___PDWW
WWWWWWWW
WWWWWWWW

***

WWWWWWWW
WWWWWWWW
WD__PDWW
WP____WW
W_____WW
W___PDWW
WWWWWWWW
WWWWWWWW

***

WWWWWWWW
WWWWWWWW
WD__PDWW
WP____WW
W_____WW
W___PDWW
WWWWWWWW
WWWWWWWW

***

WWWWWWWW
WWWWWWWW
WD__PDWW
WP____WW
W_____WW
W___PDWW
WWWWWWWW
WWWWWWWW

***

TTTTTTTT
TTTTTTTT
TTTTTTTT
TTTTTTTT
TTTTTTTT
TTTTTTTT
TTTTTTTT
TTTTTTTT

***

