PW_WW_____
BW_W______
WWWW______
W_________
___B__W___
_B_B__W_B_
WWWWWWWWWW