P W _ W W _ _ _ B _
B W P W _ _ _ _ _ _
W W W W _ _ _ _ _ _
W _ _ _ _ B _ _ _ _
_ _ _ B _ _ W _ _ _
_ _ _ B B _ W P B _
W W W W W W W W W W