__WBW_W___
__WW__W___
__________
__________
____PB___B
WB_W_B_WBB
WWWWWWWWWW