__WBW_W___
__WW__W___
_________B
____B____P
____PB_P_B
W__W_B_WBB
WWWWWWWWWW