_ _ W B W _ W _ _ _
_ _ W W _ _ W _ _ _
_ _ _ _ _ _ _ _ _ _
_ _ _ _ _ _ _ _ _ _
_ _ _ _ P B _ _ _ B
W B _ W _ B _ W B B
W W W W W W W W W W