_ _ W B W _ W _ _ _
_ _ W W _ _ W _ _ _
_ _ _ _ _ _ _ _ _ B
_ _ _ _ B _ _ _ _ P
_ _ _ _ P B _ P _ B
W _ _ W _ B _ W B B
W W W W W W W W W W