______W_WW
______W___
__________
B__P______
__B____PB_
PBW____WBW
WWWWWWWWWW