____________
____________
____________
____________
____________
_________PO_
_WWWWWWWWWW_
WWWWWWWWWWWW