W__WW____W
W________W
W________W
W________W
W__._____.
W__W_B__P.
WWWWWWWWWW