W__WW____W
W________W
W________W
W________W
W__._____.
W__W_B___.
WWWWWWWWW.