......WWW_
....._____
....._PDW_
.....WWWW_
......____
......____
WWWWWWWWWW