.....WWWW_
....______
....__PDW_
...WWWWWW_
..____..__
..____..__
WWWWWWWWWW