__W_______
WWWWWW__W_
W_________
W_______P_
________W_
_W____W_W_
WWWWWWWWWW