__________________
__________________
______________W___
____B_____W__BW___
____P_B___W__BW__O
WWWWWWWWWWWWWWWWWW