__________________
__________________
_________B____W___
_________PW__BW___
_________BW__BW__O
WWWWWWWWWWWWWWWWWW