__________
WWDWWWWWWW
__W_WWW___
_____WWW__
_WW_____WW
_W______WW
WWWWWWWWWW