_W____WW________WW____
_W________________W___
WW_________________W__
WD__________________W_
WW___________________W
_WB__________W_______W
_WB__________WB______W
_WWWWW_B'_WWWWWWWWWWWWW
_____WBP_W____________
_____WWWWW____________