_ W _ _ _ _ W W _ _ _ _ _ _ _ _ W W _ _ _ _
_ W _ _ _ _ _ _ _ _ _ _ _ _ _ _ _ _ W _ _ _
W W _ _ _ _ _ _ _ _ _ _ _ _ _ _ _ _ _ W _ _
W D _ _ _ _ _ _ _ _ _ _ _ _ _ _ _ _ _ _ W _
W W _ _ _ _ _ _ _ _ _ _ _ _ _ _ _ _ _ _ _ W
_ W _ _ _ _ _ _ _ _ _ B B W _ _ _ _ _ _ _ W
_ W _ _ _ _ _ _ _ _ _ P B W B _ _ _ _ _ _ W
_ W W W W W _ _ _ W W W W W W W W W W W W W
_ _ _ _ _ W _ _ B W _ _ _ _ _ _ _ _ _ _ _ _
_ _ _ _ _ W W W W W _ _ _ _ _ _ _ _ _ _ _ _