_ W _ _ _ _ W W _ _ _ _ _ _ _ _ W W _ _ _ _
_ W _ _ _ _ _ _ _ _ _ _ _ _ _ _ _ _ W _ _ _
W W _ _ _ _ _ _ _ _ _ _ _ _ _ _ _ _ _ W _ _
W D _ _ _ _ _ _ _ _ _ _ _ _ _ _ _ _ _ _ W _
W W _ _ _ _ _ _ _ _ _ _ _ _ _ _ _ _ _ _ _ W
_ W B _ _ _ _ _ _ _ _ _ _ W _ _ _ _ _ _ _ W
_ W B _ _ P _ _ _ _ _ _ _ W B _ _ _ _ _ _ W
_ W W W W W _ _ _ W W W W W W W W W W W W W
_ _ _ _ _ W B _ B W _ _ _ _ _ _ _ _ _ _ _ _
_ _ _ _ _ W W W W W _ _ _ _ _ _ _ _ _ _ _ _