__B_______
__P_____B_
________P_
____P_B_B_
P_W_W___B_
_W___W__PB
WWWWWWWWWW