______________________
______________________
______________________
_______W_____W________
______BW____BW________
_____BBW___BBW______G_
_WWWWWWWWWWWWWWWWWWWW_
WWWWWWWWWWWWWWWWWWWWWW