B W B W _ _ _ _ _ _
B W W _ _ _ _ _ _ _
W _ _ _ _ B _ _ _ P
_ _ B _ _ P _ P _ W
_ _ _ W _ B _ B _ W
W _ _ W _ B W B W W
W W W W W W W W W W