(7, 8, 8)
________
________
____P___
________
________
__D_____
________
________

***

________
________
___P____
________
________
__D_____
________
________

***

________
________
__P_____
________
________
__D_____
________
________

***

________
________
________
__P_____
________
__D_____
________
________

***

________
________
________
________
__P_____
__D_____
________
________

***

________
________
________
________
__P_____
__D_____
________
________

***

TTTTTTTT
TTTTTTTT
TTTTTTTT
TTTTTTTT
TTTTTTTT
TTTTTTTT
TTTTTTTT
TTTTTTTT

***

