_________W
_B__B_____
_P__P_____
_B________
_W_P___B_B
_W_B____BP
WWWWWWWWWW