_ _ _ _ _ _ _ _ _ W
B _ B _ _ _ _ P _ _
P _ P _ B _ _ _ _ B
_ B B _ P _ _ _ _ _
B W P _ _ _ B P _ _
B W _ B _ _ _ B B B
W W W W W W W W W W