__________
W_________
W_________
W_________
W_________
W_________
WWWWWWWWWW