_ . _ _ _ W W _ _ _
_ . W _ _ _ _ _ _ _
_ P W _ B _ _ _ _ _
_ P W _ P _ _ _ B _
_ B W _ B _ B _ P B
B W W W B B B _ W B
W W W W W W W W W W