_ _ _ _ _ W W _ _ _
_ _ W _ _ _ _ _ _ _
B P W _ _ _ _ B _ _
_ B W P _ B _ P _ P
_ B W _ B P _ _ _ B
B W W W B B B _ W B
W W W W W W W W W W