__________
_________W
_________W
_________W
____W____W
____WB___W
WWWWWWWWWW