____W____W
___W_____W
__W______W
_W_______W
W________W
W_____W__W
WWWWWWWWWW
