____P_P_P_
_P________
WW________
___PBB__P_
___WW____W
___WDPWDPW
WWWWWWWWWW