_ _ _ _ P _ _ _ P _
_ _ _ _ _ _ _ _ _ _
W W _ B _ B _ _ P _
_ _ _ P B _ _ _ _ _
_ B _ W W _ _ _ _ W
_ P _ W D _ W D _ W
W W W W W W W W W W