_W__WW____
_W_W_W____
_W________
__________
__________
_____W____
WWWWWWWWWW