___W_____P
___D_B_B__
___WWW_B_P
_______WBW
__B____WW_
D_W_B_PWD_
WWWWWWWWWW