_ P _ W _ _ _ P _ P
_ _ _ D P B _ _ _ _
_ B _ W W W _ _ _ _
_ P _ _ _ _ _ W _ W
_ _ B B _ B _ W W _
D _ W P _ P _ W D P
W W W W W W W W W W