W _ W W W _ _ W W W
_ W _ _ _ _ _ _ _ _
_ _ _ _ _ _ _ _ _ _
_ _ _ _ _ _ _ _ _ _
B _ _ _ _ B _ W _ _
P B B _ _ P B W _ B
W W W W W W W W W W