________
_P_D____
________
________
__D__DP_
________
__P_____
________

***

________
__PD____
________
________
__D__DP_
__P_____
________
________

***

________
__PD____
________
________
__D__DP_
__P_____
________
________

***

________
__PD____
________
________
__D__DP_
__P_____
________
________

***

________
__PD____
________
________
__D__DP_
__P_____
________
________

***

________
__PD____
________
________
__D__DP_
__P_____
________
________

***

________
__PD____
________
________
__D__DP_
__P_____
________
________

***

________
__PD____
________
________
__D__DP_
__P_____
________
________

***

________
__PD____
________
________
__D__DP_
__P_____
________
________

***

________
__PD____
________
________
__D__DP_
__P_____
________
________

***

TTTTTTTT
TTTTTTTT
TTTTTTTT
TTTTTTTT
TTTTTTTT
TTTTTTTT
TTTTTTTT
TTTTTTTT

***

