WWWWWWW
W_____W
W_W_W_W
WWWPWDW
W___WWW
W_WWW_W
W_____W
WWWWWWW