..........
..........
..........
..........
.........W
WD....._DW
WWWWWWWWWW