....._....
.._WD_....
....WWWWW_
__________
__________
__________
WWWWWWWWWW