_ _ _ _ _ _ _ _ _ _
_ _ _ _ _ _ B _ _ _
_ _ _ _ _ _ P _ _ _
_ _ B _ _ _ _ P B B
_ _ B _ _ _ B B W _
W _ P _ B B B B W P
W W W W W W W W W W