___P______
_____B____
_____P____
__B_____B_
B_B___B_WB
W_P___BBWP
WWWWWWWWWW