..........
..........
..WWWW....
..____....
..........
..........
WWWWWWWWWW