..........
..........
..........
_W_..WWWWW
W...._____
W...._P_DW
WWWWWWWWWW