_ _ _ _ _ W _ W _ _
_ B _ B _ W _ W W W
_ P _ P _ W W _ _ _
_ _ _ _ _ _ _ _ _ _
_ B _ _ B _ _ B _ W
B W P _ P B _ B B W
W W W W W W W W W W