__________
__________
_________P
__________
___B______
___P__WB_B
WWWWWWWWWW