_________B
__P____B__
_______P__
__________
___B_B___P
___PBPWB_B
WWWWWWWWWW