_ _ _ _ _ _ _ _ _ _
B _ _ _ _ B _ B _ B
P _ P _ _ P _ _ _ _
_ _ _ _ _ _ _ P _ _
_ _ _ B _ B _ _ _ P
_ B _ P B P W B _ B
W W W W W W W W W W