...WWWWW__
..._______
...__PDW__
...WWWWW__
.......___
.......___
WWWWWWWWWW