W _ _ _ . . . . _ W
W _ _ _ . P . . _ W
W _ _ . . . . . _ W
W _ _ _ _ _ _ _ _ W
W _ _ _ _ _ _ _ _ W
W _ _ _ W _ B _ _ W
W W W W W W W W W W