..........
..........
....WDW...
.___WWW__W
WB_W_____W
WBBW_____W
WWWWWWWWWW