_______WW_
_______WW_
__B_B____W
__P_PB____
__B_BB____
BBBWBBB_B_
WWWWWWWWWW