_ _ _ _ _ _
_ _ _ _ _ _
_ _ _ _ _ _
_ _ P _ _ _
_ _ D _ _ _
_ _ _ _ _ _