..........
...._.....
._WD_.....
........__
__________
__________
WWWWWWWWWW