. . . . . . . . . .
. . . . . . . . . .
. _ W . . . . . . .
. . . . . . _ _ _ _
_ _ _ _ _ _ _ _ _ _
_ _ _ _ _ _ _ _ _ _
W W W W W W W W W W