____P____B
__________
_P_B__B___
_B_P__P___
_W_B___BB_
_W_BPB_BP_
WWWWWWWWWW