.WWWWW.__W
_________W
___...___W
__....___W
__.BB.___W
__WWWWWW..
_W_______W
W________W
W____W___W
WWWWWWWWWW