_____W____
____W_W___
___W___W__
__W_____W_
_W_______W
W________W
W________W
W__._____W
W__.B_P__W
WWWWWWWWWW