..........
.__.......
..PDW.....
_WWWW___W_
__________
__P_______
WWWWWWWWWW