______________________
______________________
______________________
_________________W____
_____W___B___W__BW____
____BW___P__BW__BW__O_
_WWWWWWWWWWWWWWWWWWWW_
WWWWWWWWWWWWWWWWWWWWWW