______________________
______________________
__________________P___
_________________W____
_____W_______W__BW____
____BW______BW_BBW__O_
_WWWWWWWWWWWWWWWWWWWW_
WWWWWWWWWWWWWWWWWWWWWW