______________________
______________________
______________________
_________________W____
_____W_______W__BW____
____BW______BW_BBW_PO_
_WWWWWWWWWWWWWWWWWWWW_
WWWWWWWWWWWWWWWWWWWWWW