P_______W_
________WW
__________
__B______W
_BP_B_B_W_
__WBPBWBW_
WWWWWWWWWW