.....WWWW_
....._____
.....__DW_
....WWWWW_
......____
......____
WWWWWWWWWW