P _ _ _ _ _ _ W _ _
W _ W _ _ P _ W _ _
W _ W _ _ _ _ D _ B
_ _ _ _ _ _ _ W _ _
_ P _ P B _ _ W _ _
B W B _ W P _ D P W
W W W W W W W W W W