. . . . . . _ . . .
. . . . B B _ _ . .
. . . . . . . . W W
_ _ _ _ _ _ _ _ _ _
_ _ _ _ _ _ _ _ _ _
_ _ _ _ _ _ _ _ _ _
W W W W W W W W W W