__W_____W_
__W_____WW
_W_W____DW
_W__WWWWWW
WW________
WD__._.P_W
WWWWWWWWWW