_ _ W _ _ _ _ _ W _
_ _ W _ _ _ _ _ W W
_ W _ W _ _ _ _ D W
_ W _ _ W W W W W W
W W _ _ _ _ _ _ _ _
W D P _ P _ _ _ _ W
W W W W W W W W W W