______W_W_
B______WWB
________WW
____BP____
_____WBB_B
__D_WWWP_P
WWWWWWWWWW