_ _ _ _ _ _ W _ W B
_ _ _ _ _ _ _ W W B
_ _ _ _ _ _ _ _ W W
_ _ _ _ B _ _ _ _ _
_ _ _ _ P W B _ _ _
P _ D _ W W W P _ _
W W W W W W W W W W