_ _ _ _ _ _ W _ W _
B _ _ _ _ _ _ W W B
_ _ _ _ _ _ _ _ W W
_ _ _ _ B P _ _ _ _
_ _ _ _ _ W B B _ B
_ _ D _ W W W P _ P
W W W W W W W W W W