..........
..........
..........
..D_......
..W.......
........WW
WWWWWWWWWW