______________________
______________________
______________________
_________________W____
____W________W__BW____
___BW____B_PBW__BW__O_
_WWWWWWWWWWWWWWWWWWWW_
WWWWWWWWWWWWWWWWWWWWWW