______________________
______________________
______________________
_________________W____
____W_____B__W__BW____
___BW_____P_BW__BW__O_
_WWWWWWWWWWWWWWWWWWWW_
WWWWWWWWWWWWWWWWWWWWWW