_ _ W _ _ _ _ _ W B
_ _ W _ _ B _ W _ W
_ _ _ W W P W _ _ _
B P _ _ _ _ _ _ _ _
B B _ P _ _ _ B _ B
B B _ W B W B P _ W
W W W W W W W W W W