_ _ W _ _ _ _ _ W B
_ _ W _ B _ _ W _ W
_ _ _ W W W W _ _ _
B _ _ _ _ _ _ _ _ _
B B _ _ P _ _ _ _ B
B B _ W B W B _ _ W
W W W W W W W W W W