_ B B B _
_ P W P B
B W W W W
W _ _ _ _
W W W W W