____W___W_
____W_____
__P______B
_____B___B
____BB___B
P__WPB_WBW
WWWWWWWWWW