_ _ P _ W _ _ _ W _
_ _ _ _ W _ P _ _ _
B _ _ _ _ _ _ _ _ B
_ _ B _ _ B _ _ _ B
_ _ P _ _ B _ P B B
P _ _ W _ B B W B W
W W W W W W W W W W