P _ _ _ _ _ _ _ _ _
W _ _ _ _ B _ _ _ _
W _ _ _ _ P _ _ _ _
_ _ _ _ _ W _ _ B _
_ _ _ _ _ W _ _ P B
D _ D _ _ D _ _ B B
W W W W W W W W W W