__________
__________
__________
__________
____P_____
..........
WWWWWWWWWW