LV4.......................
__________________W_____
_________________W_W____
_______W________W___W___
______W_W______W_____W__
___WWW___W____W_______W_
__W_______W__W_________W
_W_________WW__________W
_W_____________________W
_W_____________________W
_W___________________WWW
WW___PW__________W___W__
WD____WB_________WWWWW__
WWWWW_WBB______WWW______
____WBWBBBW_W__W________
____WBWWWWWWWWWW________
____WWW_________________
