__________
____W_____
__________
W_________
WB____W___
WBB___WB__
WWWWWWWWWW