__________
__________
__________
__________
__________
...P_.....
..........