_ _ _ B B
_ _ B B _
_ _ P W P
W _ _ W W
W W W W W