(11, 8, 8)
________
____P___
________
_____D__
_D______
__P_____
________
________

***

________
________
____P___
_____D__
_D______
_P______
________
________

***

________
________
________
____PD__
_D______
_P______
________
________

***

________
________
________
____PD__
_D______
_P______
________
________

***

________
________
________
____PD__
_D______
_P______
________
________

***

________
________
________
____PD__
_D______
_P______
________
________

***

________
________
________
____PD__
_D______
_P______
________
________

***

________
________
________
____PD__
_D______
_P______
________
________

***

________
________
________
____PD__
_D______
_P______
________
________

***

________
________
________
____PD__
_D______
_P______
________
________

***

TTTTTTTT
TTTTTTTT
TTTTTTTT
TTTTTTTT
TTTTTTTT
TTTTTTTT
TTTTTTTT
TTTTTTTT

***

