WWWWWWWW
W______W
W______W
W_P____W
W______W
W____D_W
W______W
WWWWWWWW