W W W W W W W W
W _ _ _ _ _ _ W
W _ _ _ _ _ _ W
W _ _ _ _ _ _ W
W _ P _ _ _ _ W
W _ _ _ _ D _ W
W _ _ _ _ _ _ W
W W W W W W W W