_________W
________W_
__________
__________
______BW__
__W__WWWDW
WWWWWWWWWW