..........
..........
..........
..........
.......___
.......__W
WWWW......