W__WWW___W
W_BW_____W
_WWW____W_
______BW__
____B_PWP_
PWBBPWBWWB
WWWWWWWWWW