W _ _ W W W _ _ _ W
W _ P W _ _ _ _ _ W
_ W W W _ _ _ _ W _
_ _ _ _ _ _ P W _ _
B _ B _ _ _ _ W _ _
P W B B B W B W W B
W W W W W W W W W W