W _ _ _ _ _ _ _ W _
W _ _ _ _ _ _ W _ _
_ _ _ _ P _ _ W _ _
_ _ _ _ _ W _ W B _
B _ _ _ W W _ W B _
B B _ W W W B W B B
W W W W W W W W W W