W W W W W W
W W W W W W
W _ W D _ W
W P W W _ W
W _ _ _ _ W
W W W W W W