W__.______
W__.__P__W
W__WWWWWWW
._BW______
.BBW_____.
WWWW__W_WW
WWWWWWWWWW