W _ _ . _ _ _ _ _ _
W _ _ D _ P _ _ _ W
W _ _ W W W W W W W
. P B W _ _ _ _ _ _
. B B W _ _ _ _ _ W
W W W W _ _ W _ W W
W W W W W W W W W W