WW_______P
___B_____B
__W______P
__WW______
________P_
B_B__W_B_D
WWWWWWWWWW