WW_B_____P
_____B___B
B_W__P_B_P
__WW______
__________
___PBWB__D
WWWWWWWWWW