W W _ B _ _ _ _ _ P
_ _ _ _ _ B _ _ _ B
B _ W _ _ P _ B _ P
_ _ W W _ _ _ _ _ _
_ _ _ _ _ _ _ _ _ _
_ _ _ P B W B _ _ D
W W W W W W W W W W