____W___W_
___W_____W
__W______W
_W_______W
W________W
W____P__DW
WWWWWWWWWW
