_ B _ B _ _ _ _ _ _
_ _ _ _ _ B _ _ P _
_ _ _ P _ P _ _ _ W
_ _ _ B _ W _ B _ _
P W _ B _ W W _ _ _
D W _ B _ W D P _ _
W W W W W W W W W W