.__WWW....
.______...
.__WDP_...
.__WWWWWWW
..________
.._______W
WWWWWWWWWW