_______W__
________W_
_WWWWWWW__
W_______W_
WB_______W
WBB______W
WWWWWWWWWW