. . . . . . . . . .
. . . . . . . . . .
. . . . . . . . . .
. . . . . . . . . .
. . . . . . . . . W
. . . . . . . . D W
W W W W W W W W W W