_W__...__W
_W_______W
.W_______W
W________W
W________W
W__W__W__W
WWWWWWWWWW