_ _ _ _ _ _
_ _ _ G P _
_ _ _ _ _ _
_ _ _ _ _ _
_ P B O _ _
_ _ _ _ _ _