..WWWWW_..
..______..
..__PDW_..
.WWWWWW___
......____
......____
WWWWWWWWWW