_W____WW________WW____
_W________________W___
WW_________________W__
WD__________________W_
WW___________________W
_WB__________W_______W
_WB___B______WB______W
_WWWWWP__WWWWWWWWWWWWW
_____WB__W____________
_____WWWWW____________
