_W____WW________WW____
_W________________W___
WW_________________W__
WD__________________W_
WW___________________W
_W___________W_______W
_W__B_B______WB______W
_WWWWWP__WWWWWWWWWWWWW
_____WB_BW____________
_____WWWWW____________
