_W____WW________WW____
_W________________W___
WW_________________W__
WD__________________W_
WW___________________W
_W__________BW_______W
_W__________BWB_PB___W
_WWWWW___WWWWWWWWWWWWW
_____W__BW____________
_____WWWWW____________
