B _ _ B B
B P _ P W
W _ W _ W
D _ D _ D
W W W W W