W _ _ _ _ _ _ _ _ _ _ _ _ _ _ _ _ _ _ W
W _ _ _ _ _ _ _ _ _ _ _ _ _ _ _ _ _ _ W
W _ _ _ _ _ _ B _ _ _ _ _ _ _ _ _ _ _ W
W _ _ _ W _ _ _ _ _ _ _ W _ _ _ _ _ _ W
W D _ _ W _ _ P W _ _ _ W B _ _ _ _ _ W
W W W W W W W W W W W W W W W W W W W W