W _ _ _ _ _ _ _ _ _ _ _ _ _ _ _ _ _ _ W
W _ _ _ _ _ _ _ _ _ _ _ _ _ _ _ _ _ _ W
W _ _ _ _ _ _ _ _ _ _ _ _ _ _ _ _ _ _ W
W _ _ _ W _ _ _ _ _ _ _ W _ _ B' _ _ _ W
W D _ _ W _ _ _ W _ B _ W _ _ P _ _ _ W
W W W W W W W W W W W W W W W W W W W W