W _ _ _ _ _ _ _ _ _ _ _ _ _ _ _ _ _ _ W
W _ _ _ _ _ _ _ _ _ _ _ _ _ _ _ _ _ _ W
W _ _ _ _ _ _ _ _ _ _ P _ _ _ _ _ _ _ W
W _ _ _ W _ _ _ _ _ _ _ W _ _ _ _ _ _ W
W D _ _ W _ _ _ W _ B _ W B _ _ _ _ _ W
W W W W W W W W W W W W W W W W W W W W