_ _ _ _ _ _ _ _ _ _ _ _ _ _ _ _ _ _ _ _ _ _
_ _ _ _ _ _ _ _ _ _ _ _ _ _ _ _ _ _ _ _ _ _
_ _ _ _ _ _ _ _ _ _ _ _ _ _ _ _ _ _ _ _ _ _
_ _ _ _ B B B _ _ _ _ _ _ _ _ _ _ _ _ _ _ _
_ _ _ _ V W B _ _ _ _ _ _ _ _ _ _ _ _ _ _ _
_ _ B B V W B _ _ _ _ _ _ B B B B B _ _ _ _
_ _ V B B W B _ _ _ _ _ _ V W B V B B _ _ _
_ B B B V W B B B B B B B V W B V W H _ O _
_ W W W W W W W W W W W W W W W W W W W W _
W W W W W W W W W W W W W W W W W W W W W W