. . . . . .
. . P . . .
. D . . . .
. . . . . .
. . . . . .
. . . . . .