W__________________W
W__________________W
W______________P___W
W______W_______W___W
W_____BW___W__BW__DW
WWWWWWWWWWWWWWWWWWWW
