W__________________W
W__________________W
W__________________W
W______W_______W___W
W_____BWPB_W___W__DW
WWWWWWWWWWWWWWWWWWWW
