________
______P_
___D____
________
________
_D___P__
________
________

***

________
______P_
___D____
________
________
_D___P__
________
________

***

________
______P_
___D____
________
________
_D___P__
________
________

***

________
________
___D__P_
________
________
_D______
_____P__
________

***

________
________
___D____
______P_
________
_D______
____P___
________

***

________
________
___D__P_
________
________
_D______
____P___
________

***

________
________
___D____
______P_
________
_D______
____P___
________

***

________
________
___D____
_____P__
________
_D______
___P____
________

***

________
________
___D____
____P___
________
_D______
__P_____
________

***

________
________
___DP___
________
________
_D______
_P______
________

***

TTTTTTTT
TTTTTTTT
TTTTTTTT
TTTTTTTT
TTTTTTTT
TTTTTTTT
TTTTTTTT
TTTTTTTT

***

