.........._________.
.........______B____
.........__DP_WBP___
WWWWWWWWWWWWWWWWBBWW
_______________WB_W_
____P_____P____WWBWB
WWWWWWWWWWWWWWWWWWWW