.........._________.
.........._____B____
.........__D__WBP___
WWWWWWWWWWWWWWWWB_WW
_______________WBBW_
P____P_____P___WWBWB
WWWWWWWWWWWWWWWWWWWW