.........._________.
..........______B___
.........._D__WBP___
WWWWWWWWWWWWWWWWB_WW
_______________WBBW_
_P_____________WWBWB
WWWWWWWWWWWWWWWWWWWW