. . . . . . . . . . _ _ _ _ _ _ _ _ _ .
. . . . . . . . . _ _ _ _ _ _ B _ _ _ _
. . . . . . . . . _ _ D P _ W B P _ _ _
W W W W W W W W W W W W W W W W B B W W
_ _ _ _ _ _ _ _ _ _ _ _ _ _ _ W B _ W _
_ _ _ _ P _ _ _ _ _ P _ _ _ _ W W B W B
W W W W W W W W W W W W W W W W W W W W