_W_________________
_W___WWWWWWWWWWWWW_
W_W_W_____________W
W__W______________W
W_________________W
W___________B_B'___W
W_WWW_______BWPBWW_
W_W_W____W__WWWWW__
W_W_W___WW_BW______
WDW_WWWWWWBWW______
WWW_WW___WWW_______