_ W _ _ _ _ _ _ _ _ _ _ _ _ _ _ _ _ _
_ W _ _ _ W W W W W W W W W W W W W _
W _ W _ W _ _ _ _ _ _ _ _ _ _ _ _ _ W
W _ _ W _ _ _ _ _ _ _ _ _ _ _ _ _ _ W
W _ _ _ _ _ _ _ _ _ _ _ _ _ _ _ _ B W
W _ _ _ _ _ _ _ _ _ _ _ _ _ _ _ B B W
W _ W W W _ _ _ _ _ _ _ _ W B _ W W _
W _ W _ W _ B _ _ W _ _ W W W W W _ _
W _ W _ W _ P _ W W _ _ W _ _ _ _ _ _
W D W _ W W W W W W B W W _ _ _ _ _ _
W W W _ W W _ _ _ W W W _ _ _ _ _ _ _