_ W _ _ _ _ _ _ _ _ _ _ _ _ _ _ _ _ _
_ W _ _ _ W W W W W W W W W W W W W _
W _ W _ W _ _ _ _ _ _ _ _ _ _ _ _ _ W
W _ _ W _ _ _ _ _ _ _ _ _ _ _ _ _ _ W
W _ _ _ _ _ _ _ _ _ _ _ _ _ _ _ _ _ W
W _ _ _ _ _ _ _ _ _ _ _ B P _ B _ _ W
W _ W W W _ _ _ _ _ _ _ B W _ B W W _
W _ W _ W _ _ _ _ W _ _ W W W W W _ _
W _ W _ W _ _ _ W W _ B W _ _ _ _ _ _
W D W _ W W W W W W B W W _ _ _ _ _ _
W W W _ W W _ _ _ W W W _ _ _ _ _ _ _