_ W _ _ _ _ _ _ _ _ _ _ _ _ _ _ _ _ _
_ W _ _ _ W W W W W W W W W W W W W _
W _ W _ W _ _ _ _ _ _ _ _ _ _ _ _ _ W
W _ _ W _ _ _ _ _ _ _ _ _ _ _ _ _ _ W
W _ _ _ _ _ _ _ _ _ _ _ _ _ _ _ _ _ W
W _ _ _ _ _ _ _ B _ _ _ _ _ _ _ _ _ W
W _ W W W _ _ _ _ _ _ _ B W _ _ W W _
W _ W _ W _ _ _ P W _ B W W W W W _ _
W _ W _ W _ _ _ W W B B W _ _ _ _ _ _
W D W _ W W W W W W B W W _ _ _ _ _ _
W W W _ W W _ _ _ W W W _ _ _ _ _ _ _