___B______
___BB_____
___WW_____
_B____P_B_
_P__P_____
_BBWBWBBPB
WWWWWWWWWW
