P_BB______
__PB__B___
___WW_____
______P___
BP_P____B_
_BBWBWB_P_
WWWWWWWWWW
