_B_W_WWW__
_P_____W__
__________
_W________
_W___B_P__
_W_B_P_BWB
WWWWWWWWWW