________WW
__________
W_B______B
__B__BB__P
__P__W___B
P_WBBWPBBW
WWWWWWWWWW