________WW
B_____B___
W_B_____B_
__B__B____
__P__W__PB
__WB_WP_BW
WWWWWWWWWW