_ _ B _ B _ _ _ W W
_ _ _ _ _ _ _ _ _ _
W _ _ _ B _ B _ _ _
_ _ B _ _ B _ _ B _
_ _ P _ _ W B _ P B
P _ W B P W P _ B W
W W W W W W W W W W