PW______WW
WW___P____
_____W____
____BW____
___P_W_B_P
__W_BW_BBW
WWWWWWWWWW