..........
.......___
.......___
.......___
_____WWWWW
W_________
WWWWWWWWWW