__________
__________
__________
________B_
________B_
P__P_BB_P_
WWWWWWWWWW