W _ _ _ _ _ _ _ _ W
W _ _ _ _ _ _ _ _ W
W _ _ _ _ _ _ _ _ W
. _ _ _ _ _ _ _ _ W
. _ _ P _ _ _ _ _ W
. . _ W _ _ _ _ _ W
. W W W _ P _ _ _ W
. W _ . . . _ _ _ W
W . _ _ B . _ _ D W
W W W W W W W W W W