W _ _ _ _ _ _ _ _ W
W _ _ _ _ _ _ _ _ W
W _ _ _ _ _ _ _ _ W
W _ _ _ _ _ _ _ _ W
. . . . . _ _ _ _ W
. . . . _ _ _ _ _ W
. . . . _ _ _ _ _ W
. . . . _ W P _ _ W
W . . _ B W _ _ D W
W W W W W W W W W W