B__W_W____
WWW___W___
W_____W___
_____PWB__
P__B__WB_B
W_WB_BWBBP
WWWWWWWWWW