_ _ _ _ _ W _ _ _ _
W _ _ _ _ _ _ _ _ _
W _ _ _ _ _ _ _ _ _
W B W W W _ _ _ _ _
_ W D W _ _ _ _ _ _
_ _ _ _ _ _ _ _ W W
W W W W W W W W W W