_ _ _ _ _
_ _ _ _ _
_ _ P _ W
_ W _ _ W
W W W W W