_ _ _ _ _
_ B _ _ P
_ P _ _ W
_ W _ P W
W W W W W