. . . . .
. _ . . .
. _ . . .
. _ D W .
W W W W W