. . . . .
. . . . .
. _ . B _
P _ D W P
W W W W W