_ _ W W W W . . . .
_ _ _ _ _ _ _ _ _ _
_ _ W D P _ _ _ _ _
_ _ W W W W W W W _
_ _ _ _ _ _ _ _ _ W
_ _ _ _ _ _ _ _ _ W
W W W W W W W W W W