_W________
W_________
W_________
W__WP_____
___W_B__PB
B_DW_B_W_W
WWWWWWWWWW