_W________
W_________
W_________
W__W______
___WPBB__B
B_DW_BPWPW
WWWWWWWWWW