. . . . W W . . . .
. . . . . . . . . .
. . . . . . . . . .
. . . . W W W . . .
. . . . . . . . . _
. . . . . . . . . W
W W W W W W W W W W