..........
..._......
...__DW...
..........
..........
..........
WWWWWWWWWW