_ W B _ _ _ _ W _ _
_ W B B _ _ W _ W _
_ W W W W W _ _ W _
W _ _ _ _ _ _ _ W _
W _ _ _ _ _ _ _ W W
W _ _ _ _ _ P _ D W
W W W W W W W W W W