____WW___W
___W______
___W______
P____B____
B____P_BB_
BB_BBB_PWP
WWWWWWWWWW