____WW___W
___W______
B__W______
P____B____
B____P_PBB
BBP_BB__WP
WWWWWWWWWW