W___WW___W
W________W
W________W
W________W
W________W
W.__W____W
WWWWWWWWWW