W___WW___W
W________W
W________W
W________W
W________W
W___W____W
WWWWWWWWWW