W______W__
W_______W_
W________W
W________W
W__W_____W
WWWWB____W
WWWWWWWWWW