_ _ W W _ _ _ _ W _
_ _ _ _ _ D _ _ W _
_ _ W B W W W _ _ _
W W W W W W W W _ _
_ _ _ _ _ _ _ _ _ _
_ _ _ _ _ W _ W W _
W W W W W W W W W W