....._W___
........._
........._
....WWWWW_
W_______WW
W_______DW
WWWWWWWWWW