W _ _ _ _ _ _ _ _ W
W _ _ _ _ _ _ _ _ W
W _ _ _ _ _ _ _ _ W
W _ _ _ _ P _ _ _ W
W _ _ _ . . _ _ _ W
W _ _ _ B . _ _ D W
W W W W W W W W W W