_____WWW__
__________
_____D___B
_B___W___W
BB_____P__
BBB__BBWB_
WWWWWWWWWW