(11, 8, 8)
________
___P____
______D_
___D__P_
________
________
_P__D___
________

***

________
________
___P__D_
___D__P_
________
________
__P_D___
________

***

________
________
___P__D_
___D__P_
________
________
___PD___
________

***

________
________
___P__D_
___D__P_
________
________
___PD___
________

***

________
________
___P__D_
___D__P_
________
________
___PD___
________

***

________
________
___P__D_
___D__P_
________
________
___PD___
________

***

________
________
___P__D_
___D__P_
________
________
___PD___
________

***

________
________
___P__D_
___D__P_
________
________
___PD___
________

***

________
________
___P__D_
___D__P_
________
________
___PD___
________

***

________
________
___P__D_
___D__P_
________
________
___PD___
________

***

TTTTTTTT
TTTTTTTT
TTTTTTTT
TTTTTTTT
TTTTTTTT
TTTTTTTT
TTTTTTTT
TTTTTTTT

***

