(11, 8, 8)
WWWWWWWW
WWWWWWWW
WW___DWW
WW____WW
WW____WW
WWP___WW
WWWWWWWW
WWWWWWWW

***

WWWWWWWW
WWWWWWWW
WW___DWW
WW____WW
WWP___WW
WW____WW
WWWWWWWW
WWWWWWWW

***

WWWWWWWW
WWWWWWWW
WW___DWW
WWP___WW
WW____WW
WW____WW
WWWWWWWW
WWWWWWWW

***

WWWWWWWW
WWWWWWWW
WW___DWW
WW____WW
WWP___WW
WW____WW
WWWWWWWW
WWWWWWWW

***

WWWWWWWW
WWWWWWWW
WW___DWW
WW____WW
WW____WW
WWP___WW
WWWWWWWW
WWWWWWWW

***

WWWWWWWW
WWWWWWWW
WW___DWW
WW____WW
WW____WW
WW_P__WW
WWWWWWWW
WWWWWWWW

***

WWWWWWWW
WWWWWWWW
WW___DWW
WW____WW
WW____WW
WW__P_WW
WWWWWWWW
WWWWWWWW

***

WWWWWWWW
WWWWWWWW
WW___DWW
WW____WW
WW____WW
WW___PWW
WWWWWWWW
WWWWWWWW

***

WWWWWWWW
WWWWWWWW
WW___DWW
WW____WW
WW___PWW
WW____WW
WWWWWWWW
WWWWWWWW

***

WWWWWWWW
WWWWWWWW
WW___DWW
WW___PWW
WW____WW
WW____WW
WWWWWWWW
WWWWWWWW

***

TTTTTTTT
TTTTTTTT
TTTTTTTT
TTTTTTTT
TTTTTTTT
TTTTTTTT
TTTTTTTT
TTTTTTTT

***

