........__
......DW__
.......___
W____W____
WWWWWW____
__________
WWWWWWWWWW