_ _ W W W _ P W D W
P _ _ _ _ _ _ W W W
_ _ B _ _ _ _ _ _ _
B _ P _ P _ P _ _ _
_ B _ _ W _ _ _ B _
B B _ P D P W _ P W
W W W W W W W W W W