W W W W W W W W
W W W W W W W W
W W _ P D W _ W
W W _ W W W _ W
W W _ _ _ _ _ W
W W _ W W W _ W
W W _ P D W _ W
W W W W W W W W