_W________
_W________
__________
____B___B_
_B____B_BB
_PB__WPWPW
WWWWWWWWWW