_ W _ _ _ _ _ _ _ _
_ W _ _ _ _ _ _ _ _
_ _ _ _ _ _ _ _ _ _
_ _ _ _ _ _ _ _ _ _
B _ _ _ B _ _ _ B B
P _ B _ _ W _ W P W
W W W W W W W W W W