..........
..........
..........
..........
...._....W
W..._...DW
WWWWWWWWWW