WWWWW___WW
_______WW_
_____BW___
_P__WWWWWW
_BBW______
WBBW_WDW_B
WWWWWWWWWW