(11, 8, 8)
________
__D_____
______P_
________
________
__P___D_
________
________

***

________
__D___P_
________
________
__P_____
______D_
________
________

***

________
__D_____
______P_
________
___P____
______D_
________
________

***

________
__D_____
______P_
________
__P_____
______D_
________
________

***

________
__D_____
_____P__
________
__P_____
______D_
________
________

***

________
__D_____
_____P__
________
________
__P___D_
________
________

***

________
__D_____
_____P__
________
________
___P__D_
________
________

***

________
__D_____
____P___
________
________
___P__D_
________
________

***

________
__D_____
___P____
________
________
____P_D_
________
________

***

________
__DP____
________
________
________
_____PD_
________
________

***

TTTTTTTT
TTTTTTTT
TTTTTTTT
TTTTTTTT
TTTTTTTT
TTTTTTTT
TTTTTTTT
TTTTTTTT

***

