__________
______P___
______W___
__B__BWB__
__P__BW_W_
W_W_BBW_WW
WWWWWWWWWW