W W W W W W W W
W W _ _ _ _ _ W
W W W W W W W W
W W W W W W W W
W W _ D W _ W W
W W _ W W _ W W
W W _ P _ _ W W
W W W W W W W W