W _ _ _ _ _ _ _ _ _
W D W _ _ _ _ _ _ _
_ _ _ _ P _ _ _ _ W
_ _ W _ _ _ _ _ _ _
_ _ _ _ _ _ _ _ _ _
_ _ _ _ _ _ _ _ _ _
W W W W W W W W W W