_ _ _ _ _ _ _ _ _ _ _ _ _ _ _ _ _ _ _ _ _ _
_ _ _ _ _ _ _ _ _ _ _ _ _ _ _ _ _ _ _ _ _ _
_ _ _ _ _ _ _ _ _ _ _ _ _ _ _ _ _ _ _ _ _ _
_ _ _ _ _ _ _ _ _ _ _ _ _ _ _ _ _ _ _ _ _ _
_ _ _ _ _ _ _ _ _ _ _ _ _ _ _ _ _ _ _ _ _ _
_ _ B B B B _ _ B B B _ _ _ _ _ _ _ _ _ _ _
_ _ V B W B _ _ V W B _ _ _ _ _ _ _ _ _ _ _
_ B B V W B B B V W B B B B B B H _ _ _ O _
_ W W W W W W W W W W W W W W W W W W W W _
W W W W W W W W W W W W W W W W W W W W W W