_WWWWWW___
_____.....
_WDP_...__
_WWWWWW___
_________W
_________W
WWWWWWWWWW