W_____W_W_
W______W__
W_________
W_________
W_________
W___PW___W
WWWWWWWWWW
