_ _ W W _ W _ _ _ _
W W _ _ W _ _ _ _ P
_ _ _ _ _ _ _ _ _ _
B _ B B _ _ _ _ _ B
_ _ P W _ P B P _ P
W _ W W B W B B B _
W W W W W W W W W W