W_________
W_________
W____W____
WWWWWWW___
__________
XXXXXXXXXX
WWWWWWWWWW