_ W P _ P _ B _ _ _
_ W W W W W P _ _ _
_ _ _ _ _ W B _ _ _
_ _ _ B _ W B P _ _
B W _ W _ _ W _ _ _
P W _ D _ _ W B _ _
W W W W W W W W W W