. . . . . . . . . .
. . . . . . . . . .
. . D . . . . . . .
. _ W . . . . . . .
. . W . . . . . . .
. . W . . . . . . W
W W W W W W W W W W