.__WWW....
.___......
.__W......
.__WWWWWWW
..________
.._______W
WWWWWWWWWW