W W W _ _ _ _ _ _ _
_ _ _ _ _ _ _ _ _ B
_ _ _ _ _ _ _ _ _ P
_ _ _ B _ _ _ _ _ W
_ _ _ P B _ B _ B W
B P B _ B B W B B W
W W W W W W W W W W