W W W _ _ _ _ _ _ _
_ _ _ _ _ _ _ _ _ _
_ _ _ _ _ _ _ _ _ _
_ _ _ _ _ _ _ _ _ W
_ _ _ B B _ B P _ W
B P B P B B W B B W
W W W W W W W W W W