__________
_B_B_____B
__B__B_B__
__B_______
_BBP______
PBBWBP_PBP
WWWWWWWWWW