_ _ _ _ _ _ _ _ _ _
_ B _ B _ _ _ _ _ B
_ _ B _ _ B _ B _ _
_ _ B _ _ _ _ _ _ _
_ B B P _ _ _ _ _ _
P B B W B P _ P B P
W W W W W W W W W W