(11, 8, 8)
________
__P_____
________
_D______
________
________
________
________

***

________
________
__P_____
_D______
________
________
________
________

***

________
________
________
_DP_____
________
________
________
________

***

________
________
________
_DP_____
________
________
________
________

***

________
________
________
_DP_____
________
________
________
________

***

________
________
________
_DP_____
________
________
________
________

***

________
________
________
_DP_____
________
________
________
________

***

________
________
________
_DP_____
________
________
________
________

***

________
________
________
_DP_____
________
________
________
________

***

________
________
________
_DP_____
________
________
________
________

***

TTTTTTTT
TTTTTTTT
TTTTTTTT
TTTTTTTT
TTTTTTTT
TTTTTTTT
TTTTTTTT
TTTTTTTT

***

