______P_W_
P__B____WW
__________
_________W
__PB__BPW_
_BWBPBWBWP
WWWWWWWWWW
