. . . . . W W W W _
. . . . . _ _ _ _ _
. . . . . _ _ D W _
_ . . . W W W W W _
_ _ _ _ _ _ _ _ _ _
W _ _ _ _ _ _ _ _ _
W W W W W W W W W W