..........
.._____...
..P__W__..
..WWWW___W
_________W
_________W
WWWWWWWWWW