_WWW....._
_____.._W_
_WDP___W_W
_WWWWWW__W
_________W
_________W
WWWWWWWWWW