______________________
______________________
______________________
_________________W____
______W___B__W__BW____
_____BW___P_BW__BW__O_
_WWWWWWWWWWWWWWWWWWWW_
WWWWWWWWWWWWWWWWWWWWWW