..........
..........
..........
..D.......
..W.....W.
W.W.WDW.W.
WWWWWWWWWW