B_W_B_____
____P_____
__________
________B_
B____W___W
BBBBBWBW_W
WWWWWWWWWW
