..........
..........
..........
..........
..........
.......B..
WWWWWWWWWW