_ _ _ W _ _ _ _ _ .
_ _ _ _ W W W W W _
_ _ _ _ _ _ W W _ _
W P _ _ _ _ D _ _ _
W W W W W W W _ _ _
_ _ _ _ _ _ _ W _ W
W W W W W W W W W W