___W_____W
____WWWWW_
______WW__
W___P_DW__
WWWWWWW___
_______W_W
_WWWWWWWWW