_PW_B____B
W_W_P_B_BB
D_____B_PB
WP_B__B__W
W_B__BB___
DPBP_PBP_W
WWWWWWWWWW