P _ W _ _ _ _ _ _ B
W _ W _ P _ _ _ _ B
D _ _ _ _ _ B _ _ B
W _ _ _ _ B B _ _ W
W _ B _ _ _ B _ _ _
D _ B P B P B P B W
W W W W W W W W W W