W_________
W_________
W_________
W_________
W__P______
W__P____DW
WWWWWWWWWW
