. . . . . . . . . .
. . . . . . . . . .
. . . . . . . . . .
. . . . . . . . . .
. . . . . . . _ _ _
. . . . . . . _ P W
W W W W W W W W W W