W__BW_____
_WWWW_____
__________
__________
_____P_B__
__B_B__W__
WWWWWWWWWW