W___W_____
_WWWW_____
__________
__________
_______B__
__B_BP_W__
WWWWWWWWWW