W _ _ P W _ _ _ _ _
_ W W W W _ _ _ _ _
_ _ _ _ _ _ _ _ _ _
_ _ _ _ _ _ _ P _ _
_ _ _ _ _ _ _ B _ _
_ P B _ B _ _ W _ _
W W W W W W W W W W