__________________
__________________
______________W___
__________W__BW___
_________BW_BBW_PO
WWWWWWWWWWWWWWWWWW