_ _ _ _ _ _ _ _ _ _ _ _ _ _ _ _ _ _
_ _ _ _ _ _ _ _ _ _ _ _ _ _ _ _ _ _
_ _ _ _ _ _ _ _ _ _ P _ _ _ W _ _ _
_ _ _ _ _ _ _ _ _ _ W _ _ B W _ _ _
_ _ _ _ _ _ B _ _ B W _ _ B W _ _ O
W W W W W W W W W W W W W W W W W W