_ _ _ _ _ _ _ _ _ _ _ _ _ _ _ _ _ _
_ _ _ _ _ _ _ _ _ _ _ _ _ _ _ _ _ _
_ _ _ _ _ _ _ _ _ _ _ _ _ _ W _ _ _
_ _ _ _ _ _ _ _ _ _ W _ _ B W _ _ _
_ _ P _ B _ B _ _ _ W _ _ B W _ _ O
W W W W W W W W W W W W W W W W W W