_ _ _ _ _ _ _ _ _ _ _ _ _ _ _ _ _ _
_ _ _ _ _ _ _ _ _ _ _ _ _ _ _ _ _ _
_ _ _ _ _ _ _ _ _ _ _ _ _ _ W _ _ _
_ _ _ _ _ _ _ _ _ _ W B _ B W _ _ _
_ _ _ _ _ _ _ _ _ B W P _ B W _ _ O
W W W W W W W W W W W W W W W W W W