..........
........DW
.........X
_W_______W
W________W
W___W____W
WWWWWWWWWW