..........
..........
....D.....
....W.....
....W.....
.WW_W...W.
WWWWWWWWWW