.....WWWW_
....______
....__PDW_
....WWWWW_
.......___
.......___
WWWWWWWWWW