__W_____W_
__W_____WW
_W_W____DW
_W__WWWWWW
WW________
WDP_P____W
WWWWWWWWWW
