_ _ _ _ _ P W _ W _
_ _ _ P _ W W B W W
_ _ _ _ _ _ _ W _ _
_ _ P _ _ _ _ _ _ _
_ _ _ _ _ _ _ _ B P
_ P _ B B B _ _ W B
W W W W W W W W W W