_ _ _ B _ B W P W B
_ _ _ P _ W W B W W
_ _ _ _ _ _ _ W _ _
_ _ _ _ _ _ _ _ _ _
_ _ B _ _ _ _ _ B P
_ _ P _ _ _ _ P W B
W W W W W W W W W W