_ _ _ _ _ _ W _ W B
_ _ _ B _ W W _ W W
_ B _ P _ _ _ W _ _
_ _ _ _ _ _ _ _ _ _
_ _ _ _ _ P _ _ B P
_ _ B _ _ _ _ P W B
W W W W W W W W W W