(7, 6, 6)
WWWWWW
WW___W
WW_WWW
WW_WDW
WW__PW
WWWWWW

***

WWWWWW
WW___W
WW_WWW
WW_WDW
WW__PW
WWWWWW

***

WWWWWW
WW___W
WW_WWW
WW_WDW
WW__PW
WWWWWW

***

WWWWWW
WW___W
WW_WWW
WW_WDW
WW__PW
WWWWWW

***

WWWWWW
WW___W
WW_WWW
WW_WDW
WW__PW
WWWWWW

***

WWWWWW
WW___W
WW_WWW
WW_WDW
WW__PW
WWWWWW

***

TTTTTT
TTTTTT
TTTTTT
TTTTTT
TTTTTT
TTTTTT

***

