WWWWWWWW
WWWWWWWW
WW_PDW_W
WW_WWW_W
WW_____W
WWPWWW_W
WW__DW_W
WWWWWWWW

***

WWWWWWWW
WWWWWWWW
WW_PDW_W
WW_WWW_W
WW_____W
WW_WWW_W
WWP_DW_W
WWWWWWWW

***

WWWWWWWW
WWWWWWWW
WW_PDW_W
WW_WWW_W
WW_____W
WW_WWW_W
WW_PDW_W
WWWWWWWW

***

WWWWWWWW
WWWWWWWW
WW_PDW_W
WW_WWW_W
WW_____W
WW_WWW_W
WW_PDW_W
WWWWWWWW

***

WWWWWWWW
WWWWWWWW
WW_PDW_W
WW_WWW_W
WW_____W
WW_WWW_W
WW_PDW_W
WWWWWWWW

***

WWWWWWWW
WWWWWWWW
WW_PDW_W
WW_WWW_W
WW_____W
WW_WWW_W
WW_PDW_W
WWWWWWWW

***

WWWWWWWW
WWWWWWWW
WW_PDW_W
WW_WWW_W
WW_____W
WW_WWW_W
WW_PDW_W
WWWWWWWW

***

WWWWWWWW
WWWWWWWW
WW_PDW_W
WW_WWW_W
WW_____W
WW_WWW_W
WW_PDW_W
WWWWWWWW

***

WWWWWWWW
WWWWWWWW
WW_PDW_W
WW_WWW_W
WW_____W
WW_WWW_W
WW_PDW_W
WWWWWWWW

***

WWWWWWWW
WWWWWWWW
WW_PDW_W
WW_WWW_W
WW_____W
WW_WWW_W
WW_PDW_W
WWWWWWWW

***

TTTTTTTT
TTTTTTTT
TTTTTTTT
TTTTTTTT
TTTTTTTT
TTTTTTTT
TTTTTTTT
TTTTTTTT

***

