__BW_W_W_W
DWWW__WW__
WW________
__________
B__BPB_P_B
_BPBBW____
WWWWWWWWWW