_ _ B W _ W P W _ W
D W W W _ _ W W _ _
W W _ _ _ _ _ _ _ _
_ _ _ _ _ B _ _ _ _
_ _ _ _ _ P _ _ _ _
B B _ B B W _ _ _ _
W W W W W W W W W W