. . . . . . . . . .
. . . . . . . . . .
. . . W . . . . . .
. . _ W W W W . . .
. . . . . . . . . .
. . . . . . . . . .
. . . . . . . . . .