_..______.
_W___W____
_W___WB__W
_WWWWWWWWW
W_________
W_____P_DW
WWWWWWWWWW
