_W________
_W________
_W________
_W________
W_________
W______PDW
WWWWWWWWWW