_ W _ _ _ _ _ _ _ _
_ W _ _ _ _ _ _ _ _
_ W _ _ _ _ _ _ _ _
_ W _ _ _ _ _ _ _ _
W _ _ _ _ _ _ _ _ _
W _ _ _ _ P _ _ D W
W W W W W W W W W W