_ W _ _ _ _ _ _ _ _
_ W _ _ _ _ _ _ _ _
_ W _ _ _ _ _ _ _ _
_ W _ _ _ _ _ _ _ _
W _ _ _ _ _ _ _ _ _
W _ _ _ _ _ _ P D W
W W W W W W W W W W