_ . . _ _ _ _ _ _ .
_ W _ _ _ B P _ _ _
_ W _ _ _ B B _ _ W
_ W W W W W W W W W
W _ _ _ _ _ _ _ _ _
W _ _ _ P _ _ _ D W
W W W W W W W W W W