_ . . _ _ _ _ _ _ .
_ W _ _ _ W _ _ _ _
_ W _ _ _ W B _ _ W
_ W W W W W W W W W
W _ _ _ _ _ _ _ _ _
W _ _ _ _ _ P _ D W
W W W W W W W W W W