BWBP____W_
WWBBW___W_
__WWW____W
_________W
B__B___BPW
WBWBWBWPBW
WWWWWWWWWW