B W B _ _ _ _ _ W _
W W B B W _ _ _ W _
_ _ W W W _ _ _ _ W
_ _ _ _ _ _ _ _ _ W
B _ _ B _ _ _ B _ W
W B W B W _ W P B W
W W W W W W W W W W