B W B _ P _ _ _ W _
W W B _ W _ _ _ W _
_ _ W W W _ _ _ _ W
_ _ _ _ _ _ _ _ _ W
B _ P _ _ _ _ B _ W
W _ W B W _ W P B W
W W W W W W W W W W