B W _ _ P _ B _ W _
W W B _ W _ P _ W _
_ _ W W W _ _ _ _ W
_ _ _ _ _ _ _ _ _ W
B P _ _ _ B _ _ B W
W _ W B W _ W P B W
W W W W W W W W W W