(7, 8, 8)
________
________
_____D__
__D_____
_____P__
__P_____
________
________

***

________
________
_____D__
__D__P__
__P_____
________
________
________

***

________
________
_____D__
__D__P__
__P_____
________
________
________

***

________
________
_____D__
__D__P__
__P_____
________
________
________

***

________
________
_____D__
__D__P__
__P_____
________
________
________

***

________
________
_____D__
__D__P__
__P_____
________
________
________

***

TTTTTTTT
TTTTTTTT
TTTTTTTT
TTTTTTTT
TTTTTTTT
TTTTTTTT
TTTTTTTT
TTTTTTTT

***

