..WWWWW_..
.....___..
.....DW_..
..WWWWW_..
......_...
......_...
WWWWWWWWWW