(11, 8, 8)
WWWWWWWW
W_____WW
W_WPW_WW
WWW_WDWW
W___WWWW
W_WWW_WW
W_____WW
WWWWWWWW

***

WWWWWWWW
W__P__WW
W_W_W_WW
WWW_WDWW
W___WWWW
W_WWW_WW
W_____WW
WWWWWWWW

***

WWWWWWWW
W___P_WW
W_W_W_WW
WWW_WDWW
W___WWWW
W_WWW_WW
W_____WW
WWWWWWWW

***

WWWWWWWW
W____PWW
W_W_W_WW
WWW_WDWW
W___WWWW
W_WWW_WW
W_____WW
WWWWWWWW

***

WWWWWWWW
W_____WW
W_W_WPWW
WWW_WDWW
W___WWWW
W_WWW_WW
W_____WW
WWWWWWWW

***

WWWWWWWW
W_____WW
W_W_WPWW
WWW_WDWW
W___WWWW
W_WWW_WW
W_____WW
WWWWWWWW

***

WWWWWWWW
W_____WW
W_W_WPWW
WWW_WDWW
W___WWWW
W_WWW_WW
W_____WW
WWWWWWWW

***

WWWWWWWW
W_____WW
W_W_WPWW
WWW_WDWW
W___WWWW
W_WWW_WW
W_____WW
WWWWWWWW

***

WWWWWWWW
W_____WW
W_W_WPWW
WWW_WDWW
W___WWWW
W_WWW_WW
W_____WW
WWWWWWWW

***

WWWWWWWW
W_____WW
W_W_WPWW
WWW_WDWW
W___WWWW
W_WWW_WW
W_____WW
WWWWWWWW

***

TTTTTTTT
TTTTTTTT
TTTTTTTT
TTTTTTTT
TTTTTTTT
TTTTTTTT
TTTTTTTT
TTTTTTTT

***

