W_________
WDW_______
_____P___W
__W_______
__________
__________
WWWWWWWWWW