W_________
WDW______B
____P____W
__W_______
__________
__________
WWWWWWWWWW