. W . . . . . . . .
_ W _ W B . . _ _ _
_ W _ W W W W W W _
_ W W W _ _ _ _ W _
W _ _ _ _ _ _ _ W W
W _ _ _ _ _ _ _ D W
W W W W W W W W W W