..........
_..W....__
_..WWWWWW_
_WWW____W_
W_______WW
W_______DW
WWWWWWWWWW