_ _ B _ _ _ _ _ _ _
_ _ _ _ _ _ _ W _ _
_ B _ _ _ _ _ _ _ _
W W W W B _ _ _ _ _
_ _ _ P W _ W _ _ _
B _ D W D _ D _ B B
W W W W W W W W W W