_________B
B_B___B__P
BBPWB_P___
WWWWWWB__W
_____WBB_W
_____WWWBW
WWWWWWWWWW