_ _ B _ _ _ _ _ _ _
B _ P _ _ _ _ _ _ _
B B _ W B B P _ _ _
W W W W W W B _ _ W
_ _ _ _ _ W B B _ W
_ _ P _ _ W W W B W
W W W W W W W W W W