_ _ B _ B
_ _ P _ _
_ W _ _ _
B W _ P B
W W W W W