..........
......DW..
..........
......._..
.....WB___
.......B__
WWWWWWWWWW