. . . . . . . . . .
. . . . . . . . . .
. . . . . . . . . .
. . D . . . . . . .
. . W . . . . W W _
W . W . W D W . W .
W W W W W W W W W W