. . W W . . . . . .
. . . . . . . . . .
. _ _ . . . . . . .
. . . . . . . . . .
. . . . . . . . . .
. . . . . . . . . .
. . . . . . . . . .