___W__WW__
_B_D______
_P_W___B__
_________W
B_________
W_BP_P__PB
WWWWWWWWWW