___W__WW__
_B_D______
_P_W_B____
_____P___W
_______B__
W_BP_B____
WWWWWWWWWW