_ _ _ W _ _ W W _ _
_ B _ D _ _ _ _ _ _
_ P _ W _ _ _ B _ _
_ _ _ _ _ _ _ _ _ W
B _ _ _ _ _ _ _ _ _
W _ B P _ P _ _ P B
W W W W W W W W W W