_ _ _ _ _ _ _ _ _ _
_ _ _ _ _ _ _ _ _ _
_ _ _ _ _ W P W _ _
_ _ _ _ _ W W W _ _
_ _ _ _ _ W _ _ _ _
_ _ _ W _ W _ _ _ _
W W W W W W W W W W