. . . . . _ _ _ W _
. . P . _ _ _ _ W _
. . . . P _ _ W _ W
. . . . W W W _ _ W
. . . _ _ _ _ _ _ W
W _ _ . _ _ _ _ D W
W W W W W W W W W W