W W W W W W W W
W W _ _ W D P W
W W _ W W W _ W
W W _ W _ _ _ W
W W _ W _ W W W
W W W W _ W D W
W W _ _ _ _ P W
W W W W W W W W