. . W W W _ . . . .
. _ _ _ _ . . . . .
. _ P D W . . . . .
. W W W W _ . . . .
. . . . . . . . . .
. . . . . . . . . .
W W W W W W W W W W