_ _ _ _ _ _ _ _ _ _
_ _ _ _ _ _ _ _ _ W
_ _ _ _ _ _ _ _ W _
_ _ _ _ _ _ _ _ W _
_ _ _ _ _ _ _ _ _ W
W _ _ _ _ _ _ _ B W
W W W W W W W W W W