_ B _ _ _ _ _ _ _ _
_ _ W P _ B _ B _ B
_ _ W _ _ _ _ _ _ _
_ _ _ _ _ _ _ _ _ _
B _ _ B B P _ _ _ P
B _ _ P B W B _ B _
W W W W W W W W W W