___W_____W
__W_W____W
_W_W_____W
W_W___P__W
W__W__.__W
W__WBBWB_W
WWWWWWWWWW
