_W_______W
_W_______W
_W_______W
_W_______W
W________W
W____W___W
WWWWWWWWWW
