. . . . . . . . . .
. . . . . . . . . .
. . . . . . . . . .
. . . . . . . . . .
. . . . . . . . D .
. . . . . . . . . .
W W W W W W W W W W