_ _ _ _ _ _ _ _ _ _
_ _ _ _ _ _ _ _ _ _
_ _ _ _ W _ _ _ _ _
W W W W _ W _ _ P _
_ _ _ _ _ W _ _ _ W
P _ _ _ _ W _ _ _ W
W W W W W W W W W W