......_...
..........
.....P....
...WWWW...
...___..._
...___...W
WWWWWWWWWW