W___...__W
W___._.__W
W__.WWW._W
W________W
W________W
W__W_____W
WWWWWWWWWW