_ _ _ _ _ _
_ D P _ _ _
_ _ _ _ _ _
_ _ _ _ _ _
_ D _ P _ _
_ _ _ _ _ _