W________W
W________W
W________W
W________W
.___W____W
.P__WB___W
WWWWWWWWWW