(11, 12, 12)
____________
____________
____________
________D___
___PD_______
____________
_______P____
___D________
___P________
____________
____________
____________

***

____________
____________
____________
________D___
___PD_______
____________
____________
___D___P____
___P________
____________
____________
____________

***

____________
____________
____________
________D___
___PD_______
____________
____________
___D__P_____
___P________
____________
____________
____________

***

____________
____________
____________
________D___
___PD_______
____________
____________
___D___P____
___P________
____________
____________
____________

***

____________
____________
____________
________D___
___PD_______
____________
____________
___D____P___
___P________
____________
____________
____________

***

____________
____________
____________
________D___
___PD_______
____________
____________
___D________
___P____P___
____________
____________
____________

***

____________
____________
____________
________D___
___PD_______
____________
____________
___D____P___
___P________
____________
____________
____________

***

____________
____________
____________
________D___
___PD_______
____________
________P___
___D________
___P________
____________
____________
____________

***

____________
____________
____________
________D___
___PD_______
________P___
____________
___D________
___P________
____________
____________
____________

***

____________
____________
____________
________D___
___PD___P___
____________
____________
___D________
___P________
____________
____________
____________

***

TTTTTTTTTTTT
TTTTTTTTTTTT
TTTTTTTTTTTT
TTTTTTTTTTTT
TTTTTTTTTTTT
TTTTTTTTTTTT
TTTTTTTTTTTT
TTTTTTTTTTTT
TTTTTTTTTTTT
TTTTTTTTTTTT
TTTTTTTTTTTT
TTTTTTTTTTTT

***

