W__....__W
W________W
W________W
W________W
W__W_____.
W._W_BP_..
WWWWWWWWW.