W__....__W
W________W
W________W
W________W
W__.._.__W
W......__W
WWWWWWWWWW