WB________
WW_______P
______B___
________P_
__P_____B_
P_B__BB_W_
WWWWWWWWWW