....W____W
W___W____W
WWWWW____W
_________W
W________W
W__W_W___W
WWWWWWWWWW