(11, 8, 8)
________
________
______D_
______P_
________
________
________
________

***

________
________
______D_
______P_
________
________
________
________

***

________
________
______D_
______P_
________
________
________
________

***

________
________
______D_
______P_
________
________
________
________

***

________
________
______D_
______P_
________
________
________
________

***

________
________
______D_
______P_
________
________
________
________

***

________
________
______D_
______P_
________
________
________
________

***

________
________
______D_
______P_
________
________
________
________

***

________
________
______D_
______P_
________
________
________
________

***

________
________
______D_
______P_
________
________
________
________

***

TTTTTTTT
TTTTTTTT
TTTTTTTT
TTTTTTTT
TTTTTTTT
TTTTTTTT
TTTTTTTT
TTTTTTTT

***

