..........
..........
..........
..........
..........
......._DW
WWWWWWWWWW