...____...
...____...
...WWWW...
..._______
........__
........__
WWWWWWWWWW