...____...
...____...
...WWWW...
..________
........__
........__
WWWWWWWWWW