..........
..........
..........
...WW_____
W__.W_____
W..WWDW.__
WWWWWWWWWW