_ B _ B _ P _ _ P _
_ _ _ P _ B _ _ _ _
_ W _ W _ P _ _ _ _
_ _ _ _ _ _ _ P _ _
_ _ _ _ _ B _ _ _ _
B P _ B _ B _ _ D W
W W W W W W W W W W