_ _ _ _ _ _ _
_ _ _ _ _ _ _
_ _ H W _ _ _
B B V W _ _ O
W W W W W W W