_ _ _ _ _ _ _
_ B B B B _ _
_ V B W H _ _
B B V W _ _ O
W W W W W W W