B _ _ _ _ _ B _ _ _
_ _ _ _ _ _ _ _ _ B
W _ _ _ _ _ _ _ _ _
_ _ _ _ B _ B _ _ P
_ _ _ _ P _ B B _ B
_ _ _ B P _ B P B B
W W W W W W W W W W