B_____B___
_________B
W_________
____B_B__P
____P_BB_B
___BP_BPBB
WWWWWWWWWW