B _ _ _ _ _ W _ _ _
_ _ _ P _ _ _ _ B _
_ _ _ B _ _ _ _ _ _
B _ _ P _ P _ P _ B
_ _ B _ _ B _ _ _ P
P _ B _ W B B P _ W
W W W W W W W W W W