........._
........._
........__
__________
__________
W_________
WWWWWWWWWW