_ _ _ W _ _ _ P _ _
_ _ _ D _ _ _ _ _ _
_ _ _ W _ _ _ _ _ _
_ _ _ _ _ _ _ _ _ _
_ _ _ D _ _ B _ B _
B _ _ W _ P B _ W B
W W W W W W W W W W