_ _ _ W _ _ _ P _ _
_ _ _ D _ _ _ _ _ _
_ _ _ W _ _ B _ _ _
_ _ _ _ _ _ P _ _ B
_ B _ D _ _ B _ B _
B P _ W _ P B B W _
W W W W W W W W W W