W_________
W_________
W______W__
W___P___W_
W_______WW
W__P____DW
WWWWWWWWWW
