....______
..P.WWWWW_
...._____W
.._______W
W________W
W__....__W
WWWWWWWWWW