WWWWWW
WWWWWW
W____W
WPWW_W
W_DW_W
WWWWWW

***

WWWWWW
WWWWWW
W____W
W_WW_W
WPDW_W
WWWWWW

***

WWWWWW
WWWWWW
W____W
W_WW_W
WPDW_W
WWWWWW

***

WWWWWW
WWWWWW
W____W
W_WW_W
WPDW_W
WWWWWW

***

WWWWWW
WWWWWW
W____W
W_WW_W
WPDW_W
WWWWWW

***

WWWWWW
WWWWWW
W____W
W_WW_W
WPDW_W
WWWWWW

***

WWWWWW
WWWWWW
W____W
W_WW_W
WPDW_W
WWWWWW

***

WWWWWW
WWWWWW
W____W
W_WW_W
WPDW_W
WWWWWW

***

WWWWWW
WWWWWW
W____W
W_WW_W
WPDW_W
WWWWWW

***

WWWWWW
WWWWWW
W____W
W_WW_W
WPDW_W
WWWWWW

***

TTTTTT
TTTTTT
TTTTTT
TTTTTT
TTTTTT
TTTTTT

***

