_W________
_W________
_W__W_____
W_______W_
W_______WW
W____P__DW
WWWWWWWWWW
