_ _ _ _ _ _ _ _ _ _
_ W W W W W W W W _
W _ _ _ _ _ _ _ _ W
W _ _ _ _ _ _ _ _ W
W _ _ _ _ B _ _ _ W
W _ _ _ _ P _ _ _ W
W W W . W W W W W W