. . . _ . . . . . .
. . P _ _ D W . . .
. . . . . . . . . .
. . . . . . . . . .
. . . . . . . . . .
. . . . . . . . . .
W W W W W W W W W W