_ W _ _ _ _ _ _ _ _
_ W _ _ _ _ _ _ _ _
_ W _ _ _ _ _ _ _ _
_ W _ _ _ _ _ _ _ _
W _ _ _ _ W _ _ _ _
W _ _ _ B W _ P D W
W W W W W W W W W W