B W _ B _ B _ _ W _
W _ W W B P W _ W B
_ _ _ W W W W _ _ W
_ _ _ _ _ _ _ _ _ _
_ B P _ B _ P _ _ _
B B B B B _ _ W _ D
W W W W W W W W W W