B W P B _ _ _ _ W _
W _ W W B _ W _ W B
_ _ _ W W W W _ _ W
_ _ _ _ _ _ _ _ _ _
_ B _ _ _ _ _ _ _ _
_ B B B B _ P W _ D
W W W W W W W W W W