WWWWWW
WWWWWW
WPWD_W
W_WW_W
W____W
WWWWWW

***

WWWWWW
WWWWWW
W_WD_W
WPWW_W
W____W
WWWWWW

***

WWWWWW
WWWWWW
W_WD_W
W_WW_W
WP___W
WWWWWW

***

WWWWWW
WWWWWW
W_WD_W
W_WW_W
W_P__W
WWWWWW

***

WWWWWW
WWWWWW
W_WD_W
W_WW_W
W__P_W
WWWWWW

***

WWWWWW
WWWWWW
W_WD_W
W_WW_W
W___PW
WWWWWW

***

WWWWWW
WWWWWW
W_WD_W
W_WWPW
W____W
WWWWWW

***

WWWWWW
WWWWWW
W_WDPW
W_WW_W
W____W
WWWWWW

***

WWWWWW
WWWWWW
W_WDPW
W_WW_W
W____W
WWWWWW

***

WWWWWW
WWWWWW
W_WDPW
W_WW_W
W____W
WWWWWW

***

TTTTTT
TTTTTT
TTTTTT
TTTTTT
TTTTTT
TTTTTT

***

