_ _ _ _ W
_ _ _ _ W
. _ _ _ W
W _ _ _ W
W W W W W