_W__WW____
__________
__B_B__P_P
P___W_____
____D____B
_D__W_P_PB
WWWWWWWWWW