_ W _ _ W W _ _ _ _
_ _ _ _ _ _ _ _ _ _
_ _ _ _ _ _ _ _ _ P
_ _ _ _ W _ _ _ _ _
_ _ _ _ D _ B _ B _
_ D _ _ W _ P _ P B
W W W W W W W W W W