__________
______WWW_
_________W
_________W
_________W
_________W
WWWWWWWWWW