__________
__________
__________
__________
_________W
_________W
WWWWWWWWWW