_____W____
W_________
WP________
W_WWW_____
_WDW______
________WW
WWWWWWWWWW