__________
___WW___W_
__W_____W_
_WWWWWWW__
_________W
_W_______W
WWWWWWWWWW