_ P _ B _
_ _ _ P B
B _ _ _ B
P _ _ _ B
W W W W W