B W _ _ _ _ _ _ _ _
W _ _ _ _ _ B _ _ _
_ _ _ _ _ _ _ _ _ _
_ _ B W P _ _ W _ _
P _ P W _ _ _ W P B
W B W W W B B W _ B
W W W W W W W W W W