WWWWWWWW
WW__WDPW
WW_WWW_W
WW_W___W
WW_W_WWW
WWWW_WDW
WW____PW
WWWWWWWW

***

WWWWWWWW
WW__WDPW
WW_WWW_W
WW_W___W
WW_W_WWW
WWWW_WDW
WW____PW
WWWWWWWW

***

WWWWWWWW
WW__WDPW
WW_WWW_W
WW_W___W
WW_W_WWW
WWWW_WDW
WW____PW
WWWWWWWW

***

WWWWWWWW
WW__WDPW
WW_WWW_W
WW_W___W
WW_W_WWW
WWWW_WDW
WW____PW
WWWWWWWW

***

WWWWWWWW
WW__WDPW
WW_WWW_W
WW_W___W
WW_W_WWW
WWWW_WDW
WW____PW
WWWWWWWW

***

WWWWWWWW
WW__WDPW
WW_WWW_W
WW_W___W
WW_W_WWW
WWWW_WDW
WW____PW
WWWWWWWW

***

WWWWWWWW
WW__WDPW
WW_WWW_W
WW_W___W
WW_W_WWW
WWWW_WDW
WW____PW
WWWWWWWW

***

WWWWWWWW
WW__WDPW
WW_WWW_W
WW_W___W
WW_W_WWW
WWWW_WDW
WW____PW
WWWWWWWW

***

WWWWWWWW
WW__WDPW
WW_WWW_W
WW_W___W
WW_W_WWW
WWWW_WDW
WW____PW
WWWWWWWW

***

WWWWWWWW
WW__WDPW
WW_WWW_W
WW_W___W
WW_W_WWW
WWWW_WDW
WW____PW
WWWWWWWW

***

TTTTTTTT
TTTTTTTT
TTTTTTTT
TTTTTTTT
TTTTTTTT
TTTTTTTT
TTTTTTTT
TTTTTTTT

***

