__________
__________
__________
._________
._B_______
.BW_W_____
......____