____WW________WW____W_
___W________________W_
__W_________________WW
_W______B___________DW
W_______P___________WW
W_______WB__________W_
W______BWB__________W_
WWWWWWWWWWWWW___WWWWW_
____________WB__W_____
____________WWWWW_____
