____WW________WW____W_
___W________________W_
__W_________________WW
_W__________________DW
W___________________WW
W______PW___________W_
W___BB_BWB__________W_
WWWWWWWWWWWWW___WWWWW_
____________WB__W_____
____________WWWWW_____
