____WW________WW____W_
___W________________W_
__W_________________WW
_W__________________DW
W___________________WW
W___PB__W___________W_
W___BB_BW___________W_
WWWWWWWWWWWWW___WWWWW_
____________WB__W_____
____________WWWWW_____
