____WW________WW____W_
___W________________W_
__W_________________WW
_W__________________DW
W__________B________WW
W_______W__P________W_
W______BWB_B________W_
WWWWWWWWWWWWW___WWWWW_
____________WB__W_____
____________WWWWW_____
