____WW________WW____W_
___W________________W_
__W_________________WW
_W__________________DW
W___________________WW
W_______W________B_BW_
W______BW________P_BW_
WWWWWWWWWWWWW___WWWWW_
____________W__BW_____
____________WWWWW_____
