____WW________WW____W_
___W________________W_
__W_________________WW
_W__________________DW
W___________________WW
W_______W___________W_
W______BWB__PB______W_
WWWWWWWWWWWWW___WWWWW_
____________WB_BW_____
____________WWWWW_____
