____WW________WW____W_
___W________________W_
__W_________________WW
_W__________________DW
W___________________WW
W_______W__________BW_
W______BW______P___BW_
WWWWWWWWWWWWW___WWWWW_
____________WB_BW_____
____________WWWWW_____
