..........
......__..
....WDP_..
..._WWWW..
..........
..........
..........