_ _ W W _ W W _ _ _
_ _ _ _ _ _ W _ _ _
_ _ _ _ B _ _ _ _ _
_ _ P _ W _ _ B _ _
B _ _ B W B B _ B B
P B W B W P W P B P
W W W W W W W W W W