_ _ W W _ W W _ _ _
B _ _ _ _ _ W _ B _
P _ _ _ _ _ _ _ _ _
_ _ B _ W _ _ _ _ _
B _ P _ W B B _ B _
P B W B W P W _ B B
W W W W W W W W W W