..........
..........
.....D....
....WWW...
.....___..
....._W___
WWWWWWWWWW