. . . . . .
. . . . . .
. . . . . .
. . . . . .
. . . D . .
. . . . . P