W W B W _ D W _ _ _
_ _ W _ W W W _ _ _
_ _ _ _ _ _ _ _ P _
P _ _ _ _ _ _ _ _ _
B B W _ _ B _ B B _
B _ W B W P _ W P _
W W W W W W W W W W