(7, 6, 6)
WWWWWW
W_P_WW
W___WW
W___WW
W__DWW
WWWWWW

***

WWWWWW
W__PWW
W___WW
W___WW
W__DWW
WWWWWW

***

WWWWWW
W___WW
W__PWW
W___WW
W__DWW
WWWWWW

***

WWWWWW
W___WW
W___WW
W__PWW
W__DWW
WWWWWW

***

WWWWWW
W___WW
W___WW
W__PWW
W__DWW
WWWWWW

***

WWWWWW
W___WW
W___WW
W__PWW
W__DWW
WWWWWW

***

TTTTTT
TTTTTT
TTTTTT
TTTTTT
TTTTTT
TTTTTT

***

