_____W____
___WW_____
__________
_____WP___
__PDW_____
_______P__
WWWWWWWWWW