(11, 8, 8)
________
________
_____D__
________
________
________
____P___
________

***

________
________
_____D__
________
________
____P___
________
________

***

________
________
_____D__
________
____P___
________
________
________

***

________
________
_____D__
____P___
________
________
________
________

***

________
________
_____D__
_____P__
________
________
________
________

***

________
________
_____D__
_____P__
________
________
________
________

***

________
________
_____D__
_____P__
________
________
________
________

***

________
________
_____D__
_____P__
________
________
________
________

***

________
________
_____D__
_____P__
________
________
________
________

***

________
________
_____D__
_____P__
________
________
________
________

***

TTTTTTTT
TTTTTTTT
TTTTTTTT
TTTTTTTT
TTTTTTTT
TTTTTTTT
TTTTTTTT
TTTTTTTT

***

