__________
__________
___W______
__PWB_____
WW_WBB____
_WBWBBB___
WWWWWWWWWW