_________P
__________
___W______
_P_WBB____
WW_WBBP___
_WBWBBB__P
WWWWWWWWWW