P_________
_________P
___W______
P__WB_B___
WW_WBBP___
_WBWBBB___
WWWWWWWWWW