. . . . . .
. . . . . .
. . . . . .
. . . . . .
. . D . . .
P . . . . .