W _ W W W _ _ _ _ _
_ _ _ _ _ _ _ B _ _
_ _ _ _ _ _ _ _ _ _
P _ _ _ P _ W P _ _
B _ _ _ _ B W W _ _
B B _ W B B W W W _
W W W W W W W W W W