__________
_____B___B
_____B____
___B_P____
__BP_W__B_
B_WW_D_WP_
WWWWWWWWWW