_ _ _ _ _ B _ _ _ B
_ _ _ _ _ B _ _ _ _
_ _ _ _ _ B _ _ _ _
_ _ _ B _ P _ _ _ P
_ B B P _ W _ _ B _
_ P W W _ D _ W P _
W W W W W W W W W W