_B___B____
_P___P____
_________P
D________W
W____PBP__
WP_DWW_BBP
WWWWWWWWWW