_WWWWWW_WW
__________
__________
____B___P_
B__B___W__
P_WBP__WW_
WWWWWWWWWW