_________________
_________________
________B________
________P___W____
________W__BW____
_______BW__BW__O_
_WWWWWWWWWWWWWWW_
WWWWWWWWWWWWWWWWW