P _ P _ P _ P _ B _
_ _ _ _ _ _ _ _ _ _
_ _ _ _ _ _ _ _ _ _
_ B _ _ _ _ _ _ _ _
_ P _ _ _ _ _ B _ B
_ W B P _ _ _ P W P
W W W W W W W W W W