......._..
......PDW_
_____.WWW_
._.._WW___
.....__...
.W..WW...W
WWWWWWWWWW