(11, 8, 8)
________
_D__PD__
_P______
________
____D___
_P______
________
________

***

________
_D__PD__
_P______
________
____D___
_P______
________
________

***

________
_D__PD__
_P______
________
____D___
_P______
________
________

***

________
_D__PD__
_P______
________
____D___
_P______
________
________

***

________
_D__PD__
_P______
________
____D___
_P______
________
________

***

________
_D__PD__
_P______
________
____D___
__P_____
________
________

***

________
_D__PD__
_P______
________
____D___
___P____
________
________

***

________
_D__PD__
_P______
________
____D___
____P___
________
________

***

________
_D__PD__
_P______
________
____D___
____P___
________
________

***

________
_D__PD__
_P______
________
____D___
____P___
________
________

***

TTTTTTTT
TTTTTTTT
TTTTTTTT
TTTTTTTT
TTTTTTTT
TTTTTTTT
TTTTTTTT
TTTTTTTT

***

