W___..___W
W________W
W________W
W________W
W________W
W________W
W________W
W___W____W
WD__W____W
WWWWWWWWWW