W________W
W________W
W________W
W________W
W________W
W__P____DW
WWWWWWWWWW