B____B__BB
P____BPBBP
W____W_WWW
__________
_BW_______
_PWPBP_PBP
WWWWWWWWWW