..__......
..DP......
..W.......
..........
..W_______
_W__W___WW
WWWWWWWWWW