WWWWWWWW
W____W_W
W_WWWW_W
WWW____W
WDW_WW_W
WP__WDPW
WWWWWWWW
WWWWWWWW

***

WWWWWWWW
W____W_W
W_WWWW_W
WWW____W
WDW_WW_W
WP__WDPW
WWWWWWWW
WWWWWWWW

***

WWWWWWWW
W____W_W
W_WWWW_W
WWW____W
WDW_WW_W
WP__WDPW
WWWWWWWW
WWWWWWWW

***

WWWWWWWW
W____W_W
W_WWWW_W
WWW____W
WDW_WW_W
WP__WDPW
WWWWWWWW
WWWWWWWW

***

WWWWWWWW
W____W_W
W_WWWW_W
WWW____W
WDW_WW_W
WP__WDPW
WWWWWWWW
WWWWWWWW

***

WWWWWWWW
W____W_W
W_WWWW_W
WWW____W
WDW_WW_W
WP__WDPW
WWWWWWWW
WWWWWWWW

***

WWWWWWWW
W____W_W
W_WWWW_W
WWW____W
WDW_WW_W
WP__WDPW
WWWWWWWW
WWWWWWWW

***

WWWWWWWW
W____W_W
W_WWWW_W
WWW____W
WDW_WW_W
WP__WDPW
WWWWWWWW
WWWWWWWW

***

WWWWWWWW
W____W_W
W_WWWW_W
WWW____W
WDW_WW_W
WP__WDPW
WWWWWWWW
WWWWWWWW

***

WWWWWWWW
W____W_W
W_WWWW_W
WWW____W
WDW_WW_W
WP__WDPW
WWWWWWWW
WWWWWWWW

***

TTTTTTTT
TTTTTTTT
TTTTTTTT
TTTTTTTT
TTTTTTTT
TTTTTTTT
TTTTTTTT
TTTTTTTT

***

