...._.....
...___....
...____W__
______W___
___W_W____
____W____W
WWWWWWWWWW