____W___WW
__B_______
__P_______
____P_____
BPB_W_____
B_B_D__P_B
WWWWWWWWWW