_ _ P _ W _ _ _ W W
_ _ _ _ _ _ B _ _ _
B _ _ _ P _ P _ _ _
_ _ _ _ _ _ _ _ P _
_ _ B _ W _ _ _ _ _
B P B _ D _ P _ B _
W W W W W W W W W W