_____.....
_____.....
__WWWWWWW_
_W_______W
W________W
W______PDW
WWWWWWWWWW