_ _ _ _ _ _ B _ W _
_ _ _ _ _ B B _ W _
_ _ W W W W W W W _
_ W _ _ _ _ _ _ _ W
W _ _ _ _ _ _ _ _ W
W _ _ _ _ P _ _ D W
W W W W W W W W W W