__WWWWWWW_
__________
__WD___PW_
__WWWWWWW_
__________
__________
WWWWWWWWWW