_____W____
_____WWW__
_W________
W_________
W_________
WB________
WWWWWWWWWW