. . . . . . . . . .
. . . . . . . . . .
. . . . . . . . . .
. . W W W W . . . .
. . . . _ . . . . .
. . . . _ . . . . .
W W W W W W W W W W