_________W
_________W
__W______W
_W_______W
W________W
W_____P_DW
WWWWWWWWWW