________
_DP__D__
______P_
________
__D_____
_____P__
_P____D_
________

***

________
_DP__D__
_____P__
________
__D_____
_P____P_
______D_
________

***

________
_DP__D__
_____P__
________
_PD_____
______P_
______D_
________

***

________
_DP__D__
_____P__
________
_PD_____
______P_
______D_
________

***

________
_DP__D__
_____P__
________
_PD_____
______P_
______D_
________

***

________
_DP__D__
_____P__
________
_PD_____
______P_
______D_
________

***

________
_DP__D__
_____P__
________
_PD_____
______P_
______D_
________

***

________
_DP__D__
_____P__
________
_PD_____
______P_
______D_
________

***

________
_DP__D__
_____P__
________
_PD_____
______P_
______D_
________

***

________
_DP__D__
_____P__
________
_PD_____
______P_
______D_
________

***

TTTTTTTT
TTTTTTTT
TTTTTTTT
TTTTTTTT
TTTTTTTT
TTTTTTTT
TTTTTTTT
TTTTTTTT

***

