_________________W_
_WWWWWWWWWWWWW___W_
W_____________W_W_W
W______________W__W
WB________________W
WBB_______________W
_WW_BW________WWW_W
__WWWWW__W__B_W_W_W
______W__WW_P_W_W_W
______WWBWWWWWW_WDW
_______WWW___WW_WWW
