_________________W_
_WWWWWWWWWWWWW___W_
W_____________W_W_W
W______________W__W
W____B____________W
W____PB___________W
_WWB_WB_______WWW_W
__WWWWW__W____W_W_W
______WB_WW___W_W_W
______WWBWWWWWW_WDW
_______WWW___WW_WWW
