_________________W_
_WWWWWWWWWWWWW___W_
W_____________W_W_W
W__B___________W__W
W__P______________W
W__B______________W
_WWB_WB_______WWW_W
__WWWWW__W____W_W_W
______WB_WW___W_W_W
______WWBWWWWWW_WDW
_______WWW___WW_WWW
