_________________W_
_WWWWWWWWWWWWW___W_
W_____________W_W_W
W______________W__W
WB________________W
WBB_____B_________W
_WW_BW________WWW_W
__WWWWW_PW____W_W_W
______W__WW___W_W_W
______WWBWWWWWW_WDW
_______WWW___WW_WWW
