_________________W_
_WWWWWWWWWWWWW___W_
W_____________W_W_W
W_____B________W__W
W_____P___________W
W_____B___________W
_WW__WB_______WWW_W
__WWWWWB_W____W_W_W
______WB_WW___W_W_W
______WWBWWWWWW_WDW
_______WWW___WW_WWW
