_________________W_
_WWWWWWWWWWWWW___W_
W_____________W_W_W
W______________W__W
W_________________W
W_________B_______W
_WW__W____P___WWW_W
__WWWWW__WB___W_W_W
______WBBWW__BW_W_W
______WWBWWWWWW_WDW
_______WWW___WW_WWW
