_________________W_
_WWWWWWWWWWWWW___W_
W_____________W_W_W
W______________W__W
W_________________W
W_________________W
_WW__WB____B__WWW_W
__WWWWWB_W_P__W_W_W
______WBBWW___W_W_W
______WWBWWWWWW_WDW
_______WWW___WW_WWW
