_________________W_
_WWWWWWWWWWWWW___W_
W_____________W_W_W
W______________W__W
WB________________W
WBB__P____________W
_WW__WB_______WWW_W
__WWWWW__W____W_W_W
______WB_WW___W_W_W
______WWBWWWWWW_WDW
_______WWW___WW_WWW
