_________________W_
_WWWWWWWWWWWWW___W_
W_____________W_W_W
W______________W__W
W_________________W
W_________________W
_WW__W_B______WWW_W
__WWWWWP_WB___W_W_W
______WBBWW__BW_W_W
______WWBWWWWWW_WDW
_______WWW___WW_WWW
