_________________W_
_WWWWWWWWWWWWW___W_
W_____________W_W_W
W______________W__W
WB________________W
WBB_______________W
_WW_BW____B___WWW_W
__WWWWW__WP___W_W_W
______W__WW__BW_W_W
______WW_WWWWWW_WDW
_______WWW___WW_WWW
