_________________W_
_WWWWWWWWWWWWW___W_
W_____________W_W_W
W______________W__W
W_________________W
W_______B_________W
_WW__WB_______WWW_W
__WWWWWBPW____W_W_W
______WBBWW___W_W_W
______WWBWWWWWW_WDW
_______WWW___WW_WWW
