..........
.._.......
...D......
.WWWW.....
..........
...._____W
WWWWWWWWWW