_ _ _ _ _ _
_ _ _ _ D _
_ _ _ _ _ _
_ _ _ _ _ _
_ _ _ _ _ _
_ _ _ P _ _