..........
._W.......
...D......
.......___
__________
XXXXXXXXXX
WWWWWWWWWW