..........
._W.......
...D_.....
....._____
__________
XXXXXXXXXX
WWWWWWWWWW