. . . . . . . . . .
. _ . . . . . . . .
. . . . . . . . . .
. . . . . . _ _ _ _
_ _ _ _ _ _ _ _ _ _
X X X X X X X X X X
W W W W W W W W W W