________
________
________
________
________
____P_O_
_WWWWWW_
WWWWWWWW