..........
........._
........W_
......__WW
__.....___
WD....._DW
WWWWWWWWWW