.......___
.....D____
........W_
....____WW
__________
WD______DW
WWWWWWWWWW