W__WW____W
W________W
W________W
W________W
W________.
W___W____.
WWWWWWWWW.