_B_WW_____
______B_B_
__________
B_P_B_____
P_W_P_B___
B_WBW_W_BB
WWWWWWWWWW