_WWWWWW...
__.__.....
_WDP_.....
_WWWWWW__W
_________W
_________W
WWWWWWWWWW