W_____W_W_
W______W__
W_________
W_________
W____P____
W____W___W
WWWWWWWWWW
