_________W
_________W
_________W
_WWW_____W
WW_______W
WD__P____W
WWWWWWWWWW