_ _ B _ _
P _ P _ _
_ _ _ _ W
_ B P D W
W W W W W