..........
.._.......
._PDW.....
_WWWW___W_
__________
___.______
WWWWWWWWWW