. . . . . . . . . .
. . . . . . _ . . .
. . . . . D . . . .
. . . . W W W W . .
. . . _ _ _ . . . .
. . . . B _ _ _ _ _
W W W W W W W W W W