_____WW_WW
W_____WW__
W_____WW__
____W_____
B__WW_B_B_
PW_WD_B_BB
WWWWWWWWWW