__________
___WW_____
__W_______
_W________
W_________
W________W
WWWWWWWWWW