_________________
_________________
_________________
______W_____W____
_____BW____BWP___
____BBW___BBW__O_
_WWWWWWWWWWWWWWW_
WWWWWWWWWWWWWWWWW