_ _ _ _ _ _ _ _ _ _
B _ _ P _ _ _ _ _ _
_ _ _ B _ _ _ B _ _
_ _ _ P _ _ _ B _ _
W _ _ B _ B _ P _ _
W _ _ B _ P B _ B _
W W W W W W W W W W