_ _ _ _ _ _ _ _ _ _
_ _ _ _ _ _ _ _ _ _
B _ _ B _ _ _ _ _ _
P _ _ P _ _ _ B _ _
W _ _ B _ _ _ _ _ B
W _ P B B P B P B P
W W W W W W W W W W