__________
_W________
_W________
WW___P____
_____W____
W____W____
WWWWWWWWWW