..WW......
..........
.__.......
..........
..........
..........
..........