WWWWWW
WW___W
WW_WDW
WW_WWW
WWP__W
WWWWWW

***

WWWWWW
WW___W
WW_WDW
WWPWWW
WW___W
WWWWWW

***

WWWWWW
WW___W
WWPWDW
WW_WWW
WW___W
WWWWWW

***

WWWWWW
WWP__W
WW_WDW
WW_WWW
WW___W
WWWWWW

***

WWWWWW
WW_P_W
WW_WDW
WW_WWW
WW___W
WWWWWW

***

WWWWWW
WW__PW
WW_WDW
WW_WWW
WW___W
WWWWWW

***

TTTTTT
TTTTTT
TTTTTT
TTTTTT
TTTTTT
TTTTTT

***

