_W________
_W___P____
_W__W_____
W_______W_
W_______WW
W__P____DW
WWWWWWWWWW
