W__________________W
W__________________W
W__________P_______W
W___W_______W______W
WD__W___W_B_WB_____W
WWWWWWWWWWWWWWWWWWWW
