W__________________W
W__________________W
W_______B__________W
W___W___P___W______W
WD__W___W___WB_____W
WWWWWWWWWWWWWWWWWWWW
