..........
..........
...D......
..........
..........
..........
WWWWWWWWWW