__B______D
B_W______W
P_W___W__W
B_____W__W
B___B____W
B__PB_P_DW
WWWWWWWWWW