_________D
B_W______W
P_W___W__W
B_____W__W
B___B____W
B___B___DW
WWWWWWWWWW