__P______D
__W______W
__W___W__W
B_____W__W
B__BB____W
B__PB___DW
WWWWWWWWWW