________
____P___
________
_D______
____P___
________
_____D__
________

***

________
____P___
________
_D______
________
____P___
_____D__
________

***

________
________
____P___
_D______
________
________
____PD__
________

***

________
________
________
_D__P___
________
________
____PD__
________

***

________
________
________
_D___P__
________
________
____PD__
________

***

________
________
________
_D__P___
________
________
____PD__
________

***

________
________
________
_D__P___
________
________
____PD__
________

***

________
________
________
_D_P____
________
________
____PD__
________

***

________
________
________
_DP_____
________
________
____PD__
________

***

________
________
________
_DP_____
________
________
____PD__
________

***

TTTTTTTT
TTTTTTTT
TTTTTTTT
TTTTTTTT
TTTTTTTT
TTTTTTTT
TTTTTTTT
TTTTTTTT

***

