__WWWWWWW_
__________
__WD__P_W_
__WWWWWWW_
__________
__________
WWWWWWWWWW