_ _ _ _ _ P _ _ _ B
_ _ _ _ _ W _ B _ B
_ _ _ _ _ _ _ _ _ P
W _ _ _ _ _ _ P _ W
_ _ B _ B B _ _ _ _
D _ _ W _ B W B B P
W W W W W W W W W W