___B_B_P_P
_B___W___B
_______B_P
W______P_W
__B__B____
D__WBBWBP_
WWWWWWWWWW