. . . . . . . . . .
. . . . . . . . . .
. . . . . . . . . .
. . . _ _ _ _ _ . .
. . _ W _ _ _ _ . .
. _ _ W B _ _ _ . _
W W W W W W W W W W