WWWWWW_...
_______...
WDP__W_.._
WWWWWW____
__________
__________
WWWWWWWWWW