_________W
_________W
_________W
_WWW_____W
WW_______W
WD_P_____W
WWWWWWWWWW
