..........
..........
....P.....
WW.WWW....
...___....
...___....
WWWWWWWWWW