_ B _ _ _
_ P _ _ W
_ _ _ _ W
B B _ _ W
W W W W W