_W__WWWWBB
BW______WW
W_________
_________P
_B___B____
_PW__WBBBW
WWWWWWWWWW