_W__WWWWBB
BW______WW
W_________
__________
__B__B___P
BPW__WB_BW
WWWWWWWWWW