..........
..........
..........
..........
.._.......
WD_.......
WWWWWWWWWW