_ W W W W _ _ _ _ _
_ _ _ W W W W W _ _
_ W _ _ _ _ _ W W _
W W W W W D W _ _ _
_ _ _ _ _ _ _ _ _ _
_ _ _ _ _ _ _ _ W W
W W W W W W W W W W