LV4.......................
__________________W_____
_________________W_W____
_______W________W___W___
______W_W______W_____W__
___WWW___W____W_______W_
__W_______W__W_________W
_W_________WW__________W
_W____________________BW
_W___________________BBW
_W___________________WWW
WW____W_________PW___W__
WD____W_________BWWWWW__
WWWWW_W_B______WWW______
____W_W_BBW_W_BW________
____W_WWWWWWWWWW________
____WWW_________________
