LV4.......................
__________________W_____
_________________W_W____
_______W________W___W___
______W_W______W_____W__
___WWW___W____W_______W_
__W_______W__W_________W
_W_________WW__________W
_W____________________BW
_W___________________BBW
_W__________________BWWW
WW____W__________W__BW__
WD____W_________BWWWWW__
WWWWW_W______B'_WWW______
____W_W___W_WPBW________
____W_WWWWWWWWWW________
____WWW_________________
