LV4.......................
__________________W_____
_________________W_W____
_______W________W___W___
______W_W______W_____W__
___WWW___W____W_______W_
__W_______W__W_________W
_W_________WW__________W
_W_____________________W
_W_____________________W
_W________________B__WWW
WW____W__________WP__W__
WD____WB________BWWWWW__
WWWWW_WB_______WWW______
____W_WBBBW_W_BW________
____W_WWWWWWWWWW________
____WWW_________________
