WWWWWW
W___WW
WPWDWW
W_WWWW
W___WW
WWWWWW

***

WWWWWW
WP__WW
W_WDWW
W_WWWW
W___WW
WWWWWW

***

WWWWWW
W_P_WW
W_WDWW
W_WWWW
W___WW
WWWWWW

***

WWWWWW
W__PWW
W_WDWW
W_WWWW
W___WW
WWWWWW

***

WWWWWW
W__PWW
W_WDWW
W_WWWW
W___WW
WWWWWW

***

WWWWWW
W__PWW
W_WDWW
W_WWWW
W___WW
WWWWWW

***

TTTTTT
TTTTTT
TTTTTT
TTTTTT
TTTTTT
TTTTTT

***

