P _ B _ _ _ _ _ _ P
B W W _ _ _ _ _ _ B
W _ _ _ _ _ _ B _ P
_ _ B _ _ _ _ B _ _
_ _ B P B _ B W W _
P _ W B B _ P W D _
W W W W W W W W W W