..........
...P......
..........
..........
..........
..........
WWWWWWWWWW