_W_______W
_W_______W
_W_______W
W________W
W________W
W______PDW
WWWWWWWWWW