_WBPW_W___
_WWWWBW_W_
_____W_W_W
__________
B__B___P__
PW_W_W_W_W
WWWWWWWWWW