_ W B P W B W _ _ _
_ W W W W B W _ W _
_ _ _ _ _ W _ W _ W
_ _ _ _ _ _ _ _ _ _
_ _ B B _ _ _ _ _ _
_ W P W _ W P W B W
W W W W W W W W W W