_ W B P W _ W _ _ _
_ W W W W B W _ W _
_ _ _ _ _ W _ W _ W
_ _ _ _ _ _ _ _ _ _
_ _ _ B _ P _ _ _ _
P W P W _ W _ W _ W
W W W W W W W W W W