_ _ _ _ _ _ _ _ _ _
_ _ _ W W _ _ _ _ _
_ W W _ _ _ _ _ W _
_ W W D W _ W _ _ _
_ W _ _ _ _ B W _ W
_ _ _ _ W W W _ _ _
W W W W W W W W W W