__________
WWWWWW____
__________
__________
__________
____BW__PW
WWWWWWWWWW