. . . . . W _ _ W W
W W W W W _ _ _ D W
_ _ _ _ _ _ _ _ W W
_ _ _ _ _ _ _ _ D W
_ _ _ _ _ _ _ _ W W
W D _ _ _ _ _ _ D W
W W W W W W W W W W