___B______
___P____B_
P___B___W_
B_B_WW___W
W_B______W
W_P_DW__DW
WWWWWWWWWW