___B______
___P____B_
____B___W_
B___WW___W
W_B______W
W___DWP_DW
WWWWWWWWWW