WWWWWW
W_DW_W
W_WW_W
W___PW
WWWWWW
WWWWWW

***

WWWWWW
W_DW_W
W_WW_W
W__P_W
WWWWWW
WWWWWW

***

WWWWWW
W_DW_W
W_WW_W
W_P__W
WWWWWW
WWWWWW

***

WWWWWW
W_DW_W
W_WW_W
WP___W
WWWWWW
WWWWWW

***

WWWWWW
W_DW_W
WPWW_W
W____W
WWWWWW
WWWWWW

***

WWWWWW
WPDW_W
W_WW_W
W____W
WWWWWW
WWWWWW

***

TTTTTT
TTTTTT
TTTTTT
TTTTTT
TTTTTT
TTTTTT

***

