W____WW__W
W________W
W________W
W________W
W________.
W__W_____.
WWWWWWWWW.