W W W W W _ B _ _ _
_ _ _ _ _ _ P _ _ _
_ B P B _ B W _ _ _
_ P B W B W W _ _ _
B B W _ W _ _ _ P _
P W _ _ W D _ B W B
W W W W W W W W W W