B________W
B_________
W________P
____B_P___
__B_P__B__
_WP___BWWP
WWWWWWWWWW