B________W
B_B_______
W________P
__________
B___P_PB__
_W____BWWP
WWWWWWWWWW