B _ B _ _ _ _ _ _ W
B _ _ _ _ _ _ _ _ _
W _ _ _ _ _ _ _ _ P
_ _ _ _ _ _ P _ _ _
B _ _ _ P _ _ B _ _
P W P _ _ _ B W W _
W W W W W W W W W W