B _ _ _ _ _ _ _ _ W
B _ B _ _ _ _ _ _ _
W _ _ _ _ _ _ _ _ P
_ _ _ _ _ _ _ _ _ _
B _ _ _ P _ P B _ _
_ W _ _ _ _ B W W P
W W W W W W W W W W