W _ _ _ W . . . W W
W _ _ _ _ . . . _ _
W _ _ _ . . . _ _ _
W _ _ _ . . . W _ _
W _ _ W . . . W B .
W _ _ W B _ _ W W .
W W W W W W W W _ .