..........
..........
._W.......
.......___
__________
__________
WWWWWWWWWW