W W W W W W W W W W W W
W _ _ _ _ _ _ _ _ _ _ W
W _ _ _ _ _ _ _ _ _ _ W
W _ _ _ _ _ _ _ _ _ _ W
W _ _ _ _ _ _ _ P _ _ W
W _ _ _ _ _ _ _ _ _ _ W
W _ _ _ _ _ _ _ _ _ _ W
W _ _ _ _ _ _ D _ _ _ W
W _ _ _ _ _ _ _ _ _ _ W
W _ _ _ _ _ _ _ _ _ _ W
W _ _ _ _ _ _ _ _ _ _ W
W W W W W W W W W W W W