..........
..........
......_..W
.....W_WDW
.........W
W.......DW
WWWWWWWWWW