__W___WWBW
________WW
__________
__________
BB_B_B__BP
BW_W_WBW_W
WWWWWWWWWW