B _ W W _ _ W W B W
_ _ _ _ _ _ _ _ W W
_ _ _ _ B _ _ _ _ _
_ _ _ _ _ _ B _ _ _
B B P B P B P _ _ _
B W _ W _ W B W B W
W W W W W W W W W W