WWWWWWWW
W______W
W______W
W_____DW
WP_____W
W______W
W______W
WWWWWWWW