WWWWWWWW
W______W
W______W
W_____DW
W_P____W
W______W
W______W
WWWWWWWW