WWWWWWWW
W______W
W______W
W__P__DW
W______W
W______W
W______W
WWWWWWWW