W W W W W W W W
W _ _ _ _ _ _ W
W _ _ _ _ _ _ W
W _ _ _ _ _ D W
W _ P _ _ _ _ W
W _ _ _ _ _ _ W
W _ _ _ _ _ _ W
W W W W W W W W