__W_______
__________
________B_
__________
B___BWB__W
BB_BBWBW_W
WWWWWWWWWW