_ _ W _ _ _ _ _ _ _
_ _ _ _ _ _ _ _ _ _
_ _ _ _ _ _ _ _ _ _
_ _ _ _ _ _ P _ _ _
B _ _ _ B W B _ _ W
B _ _ B B W B W _ W
W W W W W W W W W W