........._
........._
........._
W__......W
W___.....W
W____....W
WWWWWWWWWW