_ W W D _ _ W _ _ _
_ _ W W _ _ W _ _ _
_ _ _ W _ _ W _ _ _
B _ _ _ W _ W _ _ B
_ B _ B W _ W _ B _
P W B W W D W B B P
W W W W W W W W W W