_ W W D _ _ W _ _ _
_ _ W W _ _ W P _ _
_ _ _ W _ _ W _ _ _
_ _ _ _ W P W _ _ _
P B _ P W _ W _ B _
_ W B W W D W P B _
W W W W W W W W W W