_ _ _ _ P _
_ D _ _ _ _
_ P _ _ _ _
_ _ _ _ _ P
_ _ _ _ _ _
_ P _ _ _ _