____W_____
W___W_____
WWWW____W_
_W_W____W_
_W_W____W_
_WWW_W_BW_
WWWWWWWWWW