_______W__
______W___
__W____W__
_W______W_
W_______WW
W_______DW
WWWWWWWWWW
