.....WWWW_
.......___
.......DW_
_..WWWWWW_
__________
W_________
WWWWWWWWWW