__WBBW__DW
__WWWWWWWW
__W_______
__WWWWWWW_
_W______WW
W____P__DW
WWWWWWWWWW