____________
____________
________P___
_______W____
______BW____
_____BBW__O_
_WWWWWWWWWW_
WWWWWWWWWWWW