W _ W W _ W _ P _ _
W _ _ _ _ _ _ W _ _
D _ _ _ _ _ _ W _ _
W _ B B P _ _ _ _ _
W _ P W _ B _ _ _ W
W W B W W B B W B W
W W W W W W W W W W