......__..
....BB__..
.......WWW
__________
__________
__________
WWWWWWWWWW