WW_B___B_P
__________
B__P_B_W_P
P_________
________B_
WD_BBPBPWP
WWWWWWWWWW