W _ _ . . . . _ _ W
W _ _ _ _ _ _ _ _ W
W _ _ _ _ _ _ _ _ W
W _ _ _ _ _ _ _ _ W
W _ _ _ _ B _ _ _ W
W _ _ _ _ P W _ _ W
W W W W W W W W W W