WW_W__WW__
W_________
__________
____B_____
_P__B_____
__WBB_WB_B
WWWWWWWWWW