WW_W__WW__
W_________
__________
____B____P
____B_____
_PWBB_WB_B
WWWWWWWWWW