W W _ W _ _ W W _ _
W _ _ _ _ _ _ _ _ _
_ _ _ _ _ _ _ _ _ _
_ _ _ _ B _ _ _ _ _
_ P _ _ B _ _ _ _ _
_ _ W B B _ W B _ B
W W W W W W W W W W