WWWWW__WW_
__________
__________
B_____B___
PB____P__B
WB_B_BW__W
WWWWWWWWWW