WWWWW__WW_
__________
__B_______
__P_______
_B___B_P_B
WB_B_BW__W
WWWWWWWWWW