W W W W W _ _ W W _
_ _ _ _ _ _ _ _ _ _
_ B _ _ _ _ _ _ _ _
_ P _ _ _ _ _ _ _ _
_ B _ _ _ B P _ _ B
W B _ B _ B W _ _ W
W W W W W W W W W W