______________________
______________________
______________________
______________B__W____
____W________WP_BW____
___BW_______BW__BW__O_
_WWWWWWWWWWWWWWWWWWWW_
WWWWWWWWWWWWWWWWWWWWWW