BW________
W_____B___
__________
__BWP__W__
P_PW___WPB
WBWWWBBW_B
WWWWWWWWWW
