_________________
_________________
_________________
________W________
____W__BW________
___BW_BBW____P_O_
_WWWWWWWWWWWWWWW_
WWWWWWWWWWWWWWWWW