_________________
_________________
_________________
________W________
____W__BW________
___BW_BBW_____PO_
_WWWWWWWWWWWWWWW_
WWWWWWWWWWWWWWWWW