..........
.........W
__._._WDWW
W__W..WW__
_._W..____
..WWW...__
WWWWWWWWWW