W W W W W W
W W W W W W
W _ W D _ W
W _ W W _ W
W P _ _ _ W
W W W W W W