. . . . . . . . . .
. . . _ . . . . . .
. . . P D _ _ . . .
. . W W W P . . . .
. . . . . . . W . .
. . . . . . B W B W
W W W W W W W W W W