B_________
W____BBW__
W____WWW__
__B_W_____
_BPWW_B_B_
PBBWD_P_WP
WWWWWWWWWW