P_____P___
W____B_W__
W____WWW__
__B_W_____
_BPWW_P_BB
PBBWD___WP
WWWWWWWWWW