WWWWWW
W___GW
W____W
WOW__W
W_WB_W
W__P_W
WWWWWW