WWWWWW
W___GW
W_BP_W
WOW__W
W_W__W
W____W
WWWWWW